有一天，我正在玩着新的玩具娃娃，沙莉文小姐又把我的大玩具娃娃放到了我衣襟里，然后又拼写了doll这个字。	Normal 44 48 doll
玄德屏人促席而告曰：“汉室倾颓，奸臣窃命，备不量力，欲伸大义于天下，而智术浅短，迄无所就。	Hard 40 44 迄无所就
比如“涕”，原来指眼泪，《庄子》里说：“哭泣无涕，中心不戚”。	Hard 27 29 不戚
其次，郭先生援例把“你有革命家的风度”改为“你这革命家的风度”，似乎改得并不很妥。	Normal 16 18 风度
要学有所成，就要“自迩”“自卑”开始，就要刻苦磨炼，持久积累。	Hard 9 11 自迩
在中国最早的新闻学著作之一《实际应用新闻学》中，邵飘萍主张记者“其脑筋无时休息，其耳目随处警备，网罗世间一切事物而待其变。”	Hard 33 35 脑筋
它不同于：“美女妖且闲，采桑歧路间；柔条纷冉冉，落叶何翩翩。”	Hard 18 23 柔条纷冉冉
正如孔子所说：“君子和而不同。”	Hard 8 14 君子和而不同
他向负责科学研究的威尔逊要了十片吗啡，以便在必要时加快结束自己。	Hard 16 18 吗啡
这时，一个四十多岁的人，从苇塘打苇回来，被敌人捉住。	Normal 23 25 捉住
这次回到家，他当即到老信客的坟头烧了香，这位老人已死去多年。	Hard 11 13 信客
因为受那良心责备不过，要逃躲也没处逃躲呀。	Normal 4 6 良心
等到我把一盘用精盐、麻油、味精、白糖精心调配好的荠菜放到餐桌上去的时候(小的时候，我可是做梦也没有想到我那可爱的荠菜会享受到今天这样的“荣华富贵”），他们也还是带着那种迁就的微笑，漫不经心地用筷子挑上几根荠菜……	Normal 16 18 白糖
幽兰吐秀乔林下，仍自盘根众草傍。	Hard 10 12 盘根
梁中书道：“礼物多已拴缚完备，如何又去不得？”	Hard 10 12 拴缚
按照古代寓言书的记载，谁能解开奇异的高尔丁死结，谁就注定成为亚洲王。	Hard 21 23 死结
从此，我读什么书都不再马马虎虎了。	Normal 0 2 从此
又如“信”，古代只指送信的人，现在的信古代叫“书”，《世说新语》：“俄而谢玄淮上信至，［谢安］看书竟，默默无言”，“信”和“书”的分别是很清楚的。	Hard 34 42 俄而谢玄淮上信至
孔乙己便涨红了脸，额上的青筋条条绽出，争辩道，“窃书不能算偷……	Normal 12 14 青筋
火柴一闪亮，马上又熄灭了，刷，汗水立刻从他额头沁出来。	Normal 21 23 额头
袁世凯的亲信陈宧对章太炎的评价更高，因为章太炎最初见到陈宧时，便说过陈宧这人是第一等人物，然而日后灭亡民国者，必此人无疑。	Hard 6 8 陈宧
云海也活了，眠熟了的兽形涛澜，又回复了伟大的呼啸，昂头摇尾地向着我们朝露染青的馒形小岛冲洗，激起了四岸的水沫浪花，震荡着这生命的浮礁，似在报告光明与欢欣之临在……	Normal 16 18 回复
与此同时，我的头发开始潮湿，我的内衣开始潮湿；我的眉毛和鼻尖开始潮湿；再走近些，我外衣有开始潮湿，我的内衣开始潮湿，我的眉毛和鼻尖开始潮湿；再走近些，我外衣开始潮湿，我的内衣开始潮湿，我的皮肤开始潮湿，我全身湿透，我像落汤鸡一样里里外外彻底湿透。	Normal 28 30 鼻尖
白头鸟在林边的鸣叫声不断传来，锯木厂的后面，黎贝尔草地上，普鲁士军队正在操练。	Hard 36 38 操练
它们将短硬的喙像北方农妇在缸沿砺刀那样，在枝上反复擦拭。	Hard 6 7 喙
“蘖”、“绝”、“拔”押韵，“生”、“形”押韵。	Hard 1 2 蘖
还有一个，什么名字记不起了，她熬不住这种生活，用了许多工夫，在上午的十五分钟休息时间里面，偷偷地托一个在补习学校念书的外头工人写了一封给她父母的家信，邮票大概是那位同情她的女工捐助的了。	Normal 59 61 外头
1969年7月20日，两名美国宇航员首次登上月球，第一眼看到的就是十分奇异的景色：这里的天空黑沉沉的，表面却洒满灿烂的阳光。	Normal 22 24 月球
曾子还说哩：“任重而道远”，“死而后已，不亦远乎！”	Hard 20 24 不亦远乎
它不同于：“美女妖且闲，采桑歧路间；柔条纷冉冉，落叶何翩翩。”	Hard 24 29 落叶何翩翩
章太炎谈兴正浓，意犹未尽，让朋友就在牢里吃，朋友正色说：你正为民国存亡绝食，我怎么忍心据案大嚼。	Hard 43 47 据案大嚼
曾子还说哩：“任重而道远”，“死而后已，不亦远乎！”	Normal 0 2 曾子
“好的希望有了五成。”	Normal 3 5 希望
象这样的冬天，乡下人叫作旱冬，对于麦的收成或者好些，但是人口却要受到损伤；旱得久了，白喉，流行性感冒等疾病自然容易上身，可是想恣意享受江南的冬景的人，在这一种冬天，倒只会得到快活一点，因为晴和的日子多了，去郊外去闲步逍遥的机会自然也多。	Hard 63 65 恣意
她一向就想望着得人欢心，被人艳漢，具有诱惑力而被人追求。	Hard 14 16 艳漢
这时候，她就梦想到那些精美的晚餐，亮晶晶的银器；梦想到那些挂在墙上的壁衣，上面绣着古装人物，仙境般的园林，奇异的禽鸟；梦想到盛在名贵的盘碟里的佳肴；梦想到一边吃着粉红色的鲈鱼或者松鸡翅膀，一边带着迷人的微笑听客人密谈。	Normal 64 66 名贵
当年小人书便宜。	Hard 2 5 小人书
（《礼记・坊记》）范仲淹所说“先天下之忧而忧，后天下之乐而乐”＂（《岳阳楼记》）也体现了这种精神。	Hard 15 22 先天下之忧而忧
在第四段“潜心学书法”和“也是重视基本功的训练的”后面，可以分别加上“开始时从点、横、撤、捺练起”，“他苦练了一个个寒冬酷暑，每次练完就到池边洗笔，天长日久，竟把池水染黑了这样添改后，论据就显得具体、生动一些，不致过于简略。	Hard 43 44 撤
范进即将这银子交与浑家打开看，一封一封雪白的细丝锭子，即便包了两锭，叫胡屠户进来，递与他道："方才费老爹的心，拿了五千钱来。	Hard 9 11 浑家
一场悲剧于焉上场。	Hard 4 6 于焉
两个虞候口里不言，肚中寻思：“这厮不值得便骂人！”	Hard 2 4 虞候
蚂蚁一骨碌爬起来，想都没想，又换了种姿势，像只蜣螂那样头顶着地，用后腿往上举。	Hard 23 25 蜣螂
胡早秋吓得要死，本能地在水中挣扎起来，搞得田立业益发艰难，一路上气喘吁吁，还喝了不少水。	Normal 22 24 立业
我悄悄地披了大衫，带上门出去。	Hard 6 8 大衫
戏唱得好，下边叫好捧场，像见到皇上，不少名角便打天津唱红唱紫、大红大紫；可要是稀松平常，要哪没哪，戏唱砸了，下边一准起哄喝倒彩，弄不好茶碗摇篮上去；茶叶末子沾满戏袍和胡须上。	Normal 56 58 一准
响尾蛇每次蜕皮时最后一个鳞片都不能脱落而加在末端，鳞环记录着岁月的痕迹，也是它慢慢聚敛的财富。	Hard 25 27 鳞环
但是对于等候在正义之宫门口的心急如焚的人们，有些话我是必须说的。	Normal 4 6 等候
它一直放在我桌子的犄角上。	Normal 6 8 桌子
先生拿着戒尺，走到孙中山跟前，厉声问道:“你会背了？”	Normal 17 19 问道
“意味着它们繁殖得很快呗。”	Normal 1 4 意味着
爸爸散步非常认真，不偷懒，不取巧，不抄近道。	Normal 10 12 偷懒
只有当人类将自己与他的建筑视为一和引以自豪时，并且比单纯的需要更进一步————他开始关心他的建筑外观之时，“建筑”才真正开始。	Normal 31 35 更进一步
手术完成之后，用相同频率的电脉冲刺激换核卵，让苏格兰黑面羊的卵细胞质与芬多席特母羊乳腺细胞的核相互协调，使这个“组装”细胞在试管里经历受精卵那样的分裂、发育而形成胚胎的过程。	Hard 13 16 电脉冲
地上的热气跟凉风搀合起来，夹杂着腥臊的干土，似凉又热；南边的半个天响晴白日，北边的半个天乌云如墨，仿佛有什么大难来临，一切都惊慌失措。	Normal 54 56 大难
故乡的河流名不见经传：只是淮河上的一个小支流，她却有一个雄伟的大名——浉。	Hard 35 36 浉
缺乏分析判断力的人，他可以研习形而上学，因为这门学问最讲究繁琐辩证。	Hard 15 19 形而上学
那壮汉一脸尴尬,支吾着:“是吗？	Normal 3 5 一脸
不过珊瑚虫也有它的“娇气”，它怕冷，怕黑暗，怕浑浊的海水，因此一般只能在温度不低于二十摄氏度、深度不超过八十米的清澈海水中生存。	Normal 47 49 深度
母亲说：“还早呢，没开足，摇不下来的。”	Hard 10 12 开足
这一回他觉得他已经打中了脑盖骨，于是又朝同一个部位打去，鲨鱼慢慢吞吞地把一块鱼肉撕掉，然后从死鱼身上滑下去了。	Normal 9 11 打中
线绕在锭子上，线穗子一层一层加大，直到大得沉甸甸的，像成熟了的肥桃。	Hard 3 5 锭子
他脸上老是有菜色，	Hard 6 8 菜色
他于是做了一间很小很小的房子，仅仅搁得下他一个人，外加一把锤子和一个刨子。	Hard 34 36 刨子
原来蓬松漂亮的头发，变得湿淋淋的，粘到一块儿去了。	Normal 19 22 一块儿
夸父又向北方跑去，想去喝大泽里的水。	Hard 12 14 大泽
李白时代的诗人，既挚恋着四川的风土文物，又向往着下江的开阔文明，长江于是就成了他们生命的便道，不必下太大的决心就解缆问桨。	Hard 9 11 挚恋
他立即设计了一个音箱草图，一时找不到材料，就拆了床板，连夜做好了音箱，接着又改装了电话机。	Normal 32 34 音箱
这一道工序技术难度很高，窑内温度始终要保持在800℃～940℃，才能使陶俑各部分受热均匀，烧出后“视之色如青石，扣之声如磬玉”。	Hard 56 62 扣之声如磬玉
我问我自己，然后我听见了回应，回应来自童年旧居旁的河水，我听见多年以前被狂风带走的苦楝树苗向我挥手示意，我在这里，我在水里！	Hard 41 45 苦楝树苗
战争时期，有一天，几发炮弹落在一所孤儿院里。	Normal 6 8 一天
于是，羿留下了最后一个太阳。	Normal 11 13 太阳
我不能天天都从容地扯下一页。	Normal 3 5 天天
真君笑道：“那猴儿才自变座土地庙哄我，我正要捣他窗棂，踢他门扇，他就纵一纵，又渺无踪迹。	Normal 7 9 猴儿
为了把情报藏好，伯瑙德夫人想了许多办法，她先是把金属管藏在一把椅子的横档中，以后又把它放在盛着剩汤的铁锅内。	Normal 31 33 椅子
自从几个勇敢的叶片跃出水面以后，许多叶片接踵而至。	Normal 7 9 叶片
街道既那么窄，结果站在最前线上的特派员同四十多个青年学生与农民，便全在城门边牺牲了。	Hard 16 19 特派员
走了会儿，脚心跟鞋袜粘在一块，好像踩着块湿泥，非常难过，本来不想再喝水，可是见了井不由得又过去灌了一气，不为解渴，似乎专为享受井水那点凉气，从口腔到胃里，忽然凉了一下，身上的毛孔猛地一收缩，打个冷战，非常舒服。	Normal 5 7 脚心
我憧憬于你们的生活，每天不止一次！	Normal 10 12 每天
眼看那大家伙得意洋洋地将菠萝卷入口中还不忘用鼻子将竹签拔出来扔掉，真叫人有点哭笑不得。	Normal 12 14 菠萝
嘎羧要走的消息长了翅膀似的的传遍全寨，男女老少都来为嘎羧送行。	Normal 14 16 传遍
一方的异彩，揭去了满天的睡意，唤醒了四隅的明霞——光明的神驹，在热奋地驰骋。	Normal 25 27 光明
手术完成之后，用相同频率的电脉冲刺激换核卵，让苏格兰黑面羊的卵细胞质与芬多席特母羊乳腺细胞的核相互协调，使这个“组装”细胞在试管里经历受精卵那样的分裂、发育而形成胚胎的过程。	Hard 33 34 质
老杜有一句诗：“四更山吐月，残夜水明楼”，后代的诗人特别喜欢。	Hard 8 13 四更山吐月
2008名乐手击缶吟诵，那吟声细细听来，分明是:“有朋自远方来，不亦乐乎？”	Hard 7 11 击缶吟诵
四百多年里，它剥蚀了古殿檐头浮夸的琉璃，淡褪了门壁上炫耀的朱红，坍圮了一段段高墙又散落了玉砌雕栏，祭坛四周的老柏树愈见苍幽，到处的野草荒藤也都茂盛得自在坦荡。	Normal 29 31 朱红
原来，包裹破了，里面的东西不见了。	Normal 8 10 里面
后来，齐宣王死了，他的儿子齐湣王继承了王位。	Hard 13 16 齐湣王
这只小朱鹮健康地成长着,后来,被送到北京动物园展出。	Hard 3 5 朱鹮
在汽车上那会儿更受罪：每当在小弹坑上颠簸一下，我就禁不住要叫喊一次；从大弹坑上开过去，倒还好受些，汽车爬了上去，又爬了下来，就像在波涛里行船。	Normal 45 47 好受
那里的椴树高大而阴凉，	Hard 3 5 椴树
就是这样，宙斯还觉得不解恨，又派了一只凶恶的鹫鹰，每天去啄食普罗米修斯的肝脏。	Hard 22 24 鹫鹰
有时他咬碎了一点骨头，有时却咬碎了自己的牙，于是他就用岩石来砸骨头，把它捣成了酱，然后吞到肚里。	Normal 8 10 骨头
亿万斯年，谁能说清从哪一刻起，不分季节，不分昼夜，不知疲倦的西风带，就开始施展它的法力？	Hard 30 33 西风带
蔺相如知道秦王丝毫没有拿城换璧的诚意，一回到宾馆，就叫手下人化了装，带着和氏璧抄小路先回赵国去了。	Normal 3 5 知道
那挑酒的汉子道：“我自挑这酒过冈子村里卖，热了在此歇凉。	Normal 4 6 汉子
王勃写的这篇《滕王阁序》，成了千古传诵的名文。	Normal 0 2 王勃
按照邵飘萍的要求，记者应当时刻生活在角色中，闲谈时，众人皆“醉”，唯我独醒，“新闻脑”始终紧张活动，一旦提笔行文，则又“状若木鸡，静穆如处子”，倾注整个身心。	Normal 13 15 时刻
迎着吹在脸上的细密的、凉凉的雨点，我看到的竟是一片花的原野．这正是前几天那片千万朵小花藏身的草地．此刻那些花儿一下子全冒了出来，顿时改天换地，整个世界铺满了全新的色彩。	Normal 48 49 ．
以前看见包弟作揖，我就想笑，这些天我在机关学习后回家，包弟向我作揖讨东西吃，我却暗暗地流泪。	Hard 19 21 机关
高邮人也善于腌鸭蛋。	Normal 7 9 鸭蛋
蝉刚把卵装满一个小孔，到稍高的地方另做新孔，蚋立刻来到这里。	Hard 22 23 蚋
均遂进文房四宝。	Hard 3 7 文房四宝
于是三人乘马引从者往隆中。	Hard 6 9 引从者
德里莫夫中尉这样坐着，没人认出他来；谈到他自己，却假装是说别人，他越坐得久，他越变得不可能暴露他的身份，不可能站起来说：你们不认识我了么，母亲，父亲，我是个怪样的人了！……	Hard 4 6 中尉
各种各样的飞禽纷纷落到河边的牛蒡草上，它们啄食牛蒡尖儿的时候，发现了爷爷的毡靴。	Hard 37 39 毡靴
我注意到成千上万的笑语地轰击在池水的表面。	Normal 15 17 池水
到了明代，海瑞要直谏，就变得聪明而冷峻了，自己先准备好棺材。	Normal 27 29 棺材
成就的太小、高低，是不在我们掌握之内的，一半靠人力，一半靠天赋，但只要坚强，就不怕失败，不怕挫折，不怕打击，不管是人事上的，生活上的，技术上的——打击；从此以后你可以孤军奋斗了。	Normal 16 18 之内
从五言律诗到七言律诗，问题很简单：只消在每句前面加上平仄相反的两个字就成了。	Hard 26 28 平仄
它们对这道菜吃得津津有味，以至于两三个星期间，这个笼子里到处都是蝉肉被吃光后剩下的头骨和胸骨，扯下来的羽翼和断肢残腿。	Normal 41 43 头骨
就这样，我们总是为了寻开心，揪掉这些不引人注目的小花。	Normal 8 10 为了
快跑，前面有个泵站，都到那里去！	Normal 3 5 前面
“到范墓去粜没有好处，”同伴间也提出了驳议。	Hard 5 6 粜
分群的时刻来到，老蜂王打算带着它的一半家口离窠而去，这时的景象就像蜂窠在进行有丝分裂。	Hard 21 25 离窠而去
每到夏天，雨来和铁头、三钻儿，还有许多小朋友，好像一群鱼，在河里钻上钻下，藏猫猫，狗刨，立浮，仰浮。	Normal 23 25 好像
而我现在看见的古代长城，何尝不就是四合院的扩大？	Normal 4 6 看见
香菱笑道：“我只爱陆放翁的诗‘重帘不卷留香久，古砚微凹聚墨多’，说的真有趣！”	Hard 23 30 古砚微凹聚墨多
相传有一次，他外出看到西晋书法家索靖书写的碑石，初看印象不深；后来他又去看，才觉出妙处。	Normal 18 20 书写
我于是用了种种法，来麻醉自己的灵魂，使我沉入于国民中，使我回到古代去，后来也亲历或旁观过几样更寂寞更悲哀的事，都为我所不愿追怀，甘心使他们和我的脑一同消灭在泥土里的，但我的麻醉法却也似乎已经奏了功，再没有青年时候的慷慨激昂的意思了。	Normal 38 40 亲历
然秦以区区之地，致万乘之势，序八州而朝同列，百有余年矣；然后以六合为家，崤函为宫；一夫作难而七庙隳，身死人手，为天下笑者，何也？	Hard 36 38 崤函
没攀登过天游峰的人，不能算到过武夷山。	Normal 10 12 不能
20多年的心血转眼之间化为乌有，这对任何人来说都是致命的打击，更何况此时的谈迁已经是体弱多病的老人了。	Normal 25 27 致命
难道你竟要开着玩笑走到上帝森严的神座前吗？	Normal 11 13 上帝
在美国，以快捷、价廉取胜，并被大众所广泛接受的麦当劳，虽然在北京也受到了热烈的欢迎，但其中被赋予的意义与其美国祖源地却有很大的不同。	Normal 51 53 与其
杀鸡，宰鹅，买猪肉，用心细细的洗，女人的臂膊都在水里浸得通红，有的还带着绞丝银镯子。	Normal 28 30 通红
及至始皇，奋六世之余烈，振长策而御宇内，吞二周而亡诸侯，履至尊而制六合，执敲扑而鞭笞天下，威振四海。	Hard 40 42 鞭笞
而淮南小山的《招隐士》里又说：“桂树丛生兮山之幽。”	Hard 18 20 丛生
我们喜欢打水漂，看石片在水里钻进钻出。	Normal 2 4 喜欢
各类店铺经营着罗锦布匹、沉檀香料、香烛纸马，另有医药门诊、大车修理、看相算命、修面整容，应有尽有。	Normal 36 38 算命
成串的葡萄挂在架子上，利用流动的热空气，让水分蒸发掉，就成了葡萄干。	Normal 7 9 架子
我的眼里噙满了泪水。	Hard 4 6 噙满
我听得斋公们说：打了天上的星宿，阎王就要拿去打一百铁棍，发在十八层地狱，永不得翻身。	Hard 3 5 斋公
我一时不知所措,窘得满脸通红。	Hard 8 10 窘得
部队今天非夜里行军不可，她的房子和篱笆都是枯竹编成的，我们生怕有人拆下来当火把点，就写了几条标语，用米汤贴在外面显眼的地方，告知我们的部队不准拆篱笆当火把。	Normal 56 58 显眼
它们在这里筑巢安家，养育后代。	Normal 10 12 养育
书主被糟蹋到这种程度，怎能不潸然泪下欤。	Hard 14 18 潸然泪下
武松回到青石上坐了半歇，想道：“天色看看黑了，如果再跳出一只大虫来，却怎么斗得过？	Hard 9 11 半歇
摄影记者急迫地喊着：“向这里看，居里夫人！	Normal 16 20 居里夫人
他叫起来，看见我平心静气，觉得奇怪，“您在说什么呀？”	Normal 15 17 奇怪
孩子们活蹦乱跳地背上书包回家了，达丽玛低着头走进了办公室。	Normal 10 12 书包
“后之视今，亦犹今之视昔”，你们不久也要走这条路呢！	Hard 11 12 昔
在第四段“潜心学书法”和“也是重视基本功的训练的”后面，可以分别加上“开始时从点、横、撤、捺练起”，“他苦练了一个个寒冬酷暑，每次练完就到池边洗笔，天长日久，竟把池水染黑了这样添改后，论据就显得具体、生动一些，不致过于简略。	Normal 17 20 基本功
要到东关看五猖会去了。	Normal 8 9 去
“天行健，君子以自强不息；地势坤，君子以厚德载物。”	Hard 1 4 天行健
古老的赫尔维希亚联邦最高委员会及其尊敬的主席、被上帝和人类所爱的沃州地区的资深代表、这个最慷慨和热情好客的城市的领导人士、享誉世界的歌星以及一支精心挑选的朝气蓬勃的体育队伍聚集在这里，为这次盛会树立了历史性、公民精神、自然性、青春和艺术性五重声誉。	Normal 24 26 上帝
我全身用力，肌肉紧张，整个人收缩得像一块铁。	Normal 6 8 肌肉
大些的轻声吆喝她：	Normal 3 5 轻声
玄德屏人促席而告曰：“汉室倾颓，奸臣窃命，备不量力，欲伸大义于天下，而智术浅短，迄无所就。	Hard 0 3 玄德屏
紫貂和黑熊不得不躲进各自的洞里。	Normal 3 5 黑熊
在我们这儿是零碎的，薄弱的，到你们那儿发展得明朗圆满。	Normal 17 19 那儿
小朋友临走时，槐乡的孩子还会送他一大包蒸过晒干的槐花，外加一小罐清亮清亮的槐花新蜜。	Hard 39 41 新蜜
当时足球被称为“鞠”。	Hard 8 9 鞠
他们用两把大剪刀在空中裁了一阵子，同时用没有穿线的针缝了一通。	Hard 28 30 一通
积成峁，堆成墚，又堆积成一大片一大片的塬。	Hard 19 20 塬
走到三阳春的门口，便可以看见书店里仍像往日那样地挤满了顾客，我可以安心了。	Hard 3 5 阳春
这银河像一个扁平的车轮，直径约十万光年，而且像车轮一样在旋转着，因此各颗星都以不同的速度在绕着中心移动。	Normal 17 19 光年
明屠本畯有一首诗，叙述煎荔枝的方法，说“旋沉荔花蜂酿蜜，清香不减蔗浆寒”，大概是关于荔枝蜜最早的记载。	Hard 0 4 明屠本畯
布热金卡应当是个永远没有阳光、百花永远凋谢的地方，因为这里曾经是人间地狱。	Normal 8 10 永远
站在罗布泊边缘，你能看清那一道道肋骨的排列走向，看到沧海桑田的痕迹，你会感到这胸膛里面深藏的痛苦与无奈。	Normal 31 33 痕迹
这渴慕是从一个远房的叔祖惹起来的。	Hard 10 12 叔祖
金奎叔是个结实的汉子，他伸出胳膊来比我的腿还粗。	Normal 5 7 结实
承彦曰：“老夫在小婿家观《梁父吟》，记得这一篇；适过小桥，偶见篱落间梅花，故感而诵之。	Hard 37 42 故感而诵之
假如我住在这里的，反不来看一下，不是要给他们笑作痴呆么？	Normal 0 2 假如
他以做学问起步，从枯燥的架构分析、材料分析、形状勾勒等等专业常识，走进了包容历史与现实的人类精神。	Normal 22 24 形状
大熊猫是我国特有的珍稀动物，也是世界上最负盛名的濒危动物。	Normal 6 8 特有
有弗学，学之弗能弗措也；有弗问，问之弗知弗措也；有弗思，思之弗得弗措也；有弗辨，辨之弗明弗措也；有弗行，行之弗笃弗措也。	Hard 24 27 有弗思
“止水结冰是何情状？	Hard 7 9 情状
赛会虽然不像现在上海的旗袍，北京的谈国事，为当局所禁止，然而妇孺们是不许看的，读书人即所谓士子，也大抵不肯赶去看。	Normal 4 6 不像
正发呆时，陡听得‘当’的一声，又若金钟铜磬一般，倒吓得不住的展眼儿。	Hard 30 33 展眼儿
当隆冬时节，山涧的清流都结了冰，群山也覆盖着白雪，我家这泉水还蒸腾着温暖的水汽，它的四周还是绿草丛生。	Normal 28 30 泉水
接着，两只枯瘦的手向前伸去，仿佛要捉住它似的。	Normal 17 19 捉住
这时你涌起来的感想也许是“雄壮”，也许是“伟大”，诸如此类的形容词；然而同时你的眼睛也许觉得有点倦怠，你对当前的“雄壮”或“伟大”闭了眼，而另一种味儿在你心头潜滋暗长了——“单调”。	Normal 30 33 形容词
她松松地皱缬着，像少妇拖着的裙幅，她轻轻地摆弄着，像跳动的初恋的处女的心:她滑滑地明亮着，像涂了“明油”一般，有鸡蛋清那样软，那样嫩，令人想着所曾触过的最嫩的皮肤，她又不杂些儿尘滓，宛然一块温润的碧玉，只清清的一色————但你却看不透她！	Hard 4 6 皱缬
一气之下，先生把诸葛亮撵出了学堂。	Normal 14 16 学堂
大约具有太阳质量的恒星不是变成白矮星就是变成中子星〔中子星〕恒星在核能耗尽后，经过引力坍缩，依靠简并中子的压力与引力平衡形成的星体。	Hard 43 45 坍缩
现在是早已并屋子一起卖给朱文公的子孙了，连那最末次的相见也已经隔了七八年，其中似乎确凿只有一些野草；但那时却是我的乐园。	Hard 5 6 并
并且，我想就是来得大些，也不见得如人们所大吹的那么“奇观”，自己从前所幻想的那么奇目吧？	Hard 40 42 奇目
李震说“河水很深，不能徒涉。”	Hard 11 13 徒涉
将军既帝室之胄，信义著于四海，总揽英雄，思贤如渴，若跨有荆、益，保其岩阻，西和诸戎，南抚彝、越，外结孙权，内修政理；待天下有变，则命一上将将荆州之兵以向宛洛，将军身率益州之众以出秦川，百姓有不箪食壶浆以迎将军者乎？	Hard 32 36 保其岩阻
他整天呆在邯郭的大街上，看人家走路，边看边琢磨人家走路的特点，还跟在后边模仿。	Hard 5 7 邯郭
但是，帝王却把“文死谏”和“武死战”并列，要求臣子不顾身家性命，把“犯颜直谏”当做忠臣的表率。	Hard 8 11 文死谏
他们唱给天空听，天那么高，调子爱扯多高就扯多高，没人会笑他们扯不上去；他们唱给牛羊和花草听，牛羊爱听不听，只顾悠闲地吃草；他们唱给大地听，大地绵延数里，歌的尾音就可以爱拖多远就拖多远，没人会笑他们荒腔走板；何况人群又离得那样远，声音就爱唱多响就唱多响，没人会怪他们五音不全、叨扰四邻。	Hard 98 102 荒腔走板
极天云一线异色，须臾成五采。	Hard 8 10 须臾
他拉着我，坐在一根伐倒的树干上，把这朵花擎在我的眼前，说：“仔细看看，仔细看看，时间已经不多了！”	Hard 20 21 擎
劳累了一上午，连水都没喝一口，只觉得周身困乏疼痛，她不得不费力地爬到床上休息。	Normal 29 31 费力
还没有跑到，忽然看见：有一辆电车开进车站，那个智慧员，年轻的骑兵少校，跟别的乘客一样正预备挤上车去。	Normal 30 32 骑兵
看吧，狂风紧紧抱起一层层巨浪，恶狠狠地把它们甩到悬崖上，把这些大块的翡翠摔成尘雾和碎末。	Normal 24 26 悬崖
水要喷出来，或者身体哪里破了流血，它立即上去按住；护士给病人打针时它要负责把注射液推入人体；握扫帚把柄时，它要独当一面；攥、捏、握、捻、弹、揪都离不开它。	Hard 60 61 攥
当时已经用灌气的球代替了用鬃毛填充的球，而且有了球门和规则的球场，设备器材方面也逐渐完善。	Hard 13 15 鬃毛
这闭着的眼睛便看见一切圆满，当前的苦痛不过是“天之将降大任于是人也，必先苦其心志，劳其筋骨，饿其体肤，空乏其身，行拂乱其为”。	Hard 23 33 天之将降大任于是人也
“后之视今，亦犹今之视昔”，你们不久也要走这条路呢！	Normal 24 25 呢
后来，爸爸妈妈在路旁植树，如今大路已为行人撑起了遮阴的伞。	Normal 15 17 大路
爸爸说：“近年来回国旅行的美国华侨络绎不绝，叔公应该是头一个踏上旅程的。	Hard 15 17 华侨
这时，数十只幼龟已成了嘲鸫、海鸥、铿鸟的口中之食，我们的向导摘下头上的棒球帽，迅速抓起十数只幼龟，放进帽中，向海边奔去。	Hard 17 19 铿鸟
于是，他再一次去请福楼拜指导。	Normal 0 2 于是
还请了一个细娃当裁判。	Hard 5 7 细娃
“文件还须加以修正，这一克镭，应该永远属于科学。	Normal 19 21 属于
这时，他的同伴突然醒来，开始大声咳嗽，痰卡在嗓子里。	Normal 0 2 这时
高楼大厦的霓虹灯光彩夺目，热情欢迎来自五洲四海的游客。	Hard 5 8 霓虹灯
他们被挑选出来做角斗士，要被关进角斗士学校进行艰苦野蛮的训练，其目的是在竞技场上“表演”得更精彩，以使看台上的奴隶主们更高兴。	Hard 8 11 角斗士
天啊，如果我能把那条出名难学的分词用法从头到尾说出来，声音响亮，口齿清楚，又没有一点儿错误，那么任何代价我都愿意拿出来的。	Normal 10 12 出名
妈妈还是死命追着不放，到底追上了，伸手一抓，可是雨来浑身光溜溜的像条小泥鳅，一下没抓住，只听见扑通一声，雨来扎在河里不见了。	Normal 45 47 听见
棋下得正酣，胜负就在呼吸之际，客人来了，他一跺脚说，真是不巧！	Normal 15 17 客人
肚子里先有了这三个人作了底子，然后再把陶渊明、应玚，谢、阮、庾、鲍等人的一看。	Hard 32 34 鲍等
雪还铺在地上，又潮湿，又荒凉；一阵刺骨的寒风吹起他的大衣的衣襟，在他的耳朵里凄惨地号叫着。	Normal 26 28 大衣
现代的所谓创造性思维，包括扩散思维和集中思维。	Normal 3 5 所谓
狂风大作的时候我在温暖的室内，却不会想到风是如何污辱我和我的树苗的——它把我的树从窗台上抱起来，砸在河边石埠上，然后又把树苗从花盆里拖出来，推向河水里，将一只破碎的花盆和一抔泥土留在岸上，留给我。	Hard 52 54 石埠
蘸糖葫芦必须用冰糖，绵白糖才行，蘸出来不亮。	Normal 17 19 出来
窗子完全打开了，房间里还坐不牢。	Hard 12 15 坐不牢
即使是盲聋人，也无法剥夺他们这种从先代遗传下来的天赋。	Normal 21 23 下来
于是他决心重新编写一部比较完善的药物书。	Normal 0 2 于是
这意味着，宇宙最终可能会坍缩，但是这个时间不会比迄今已经膨胀过的一百五十亿年左右长太多。	Normal 1 4 意味着
三座大殿矗立在七米多高的白石台基上。	Normal 2 4 大殿
他扬鞭一挥，车便辚辚向前。	Normal 0 1 他
这天下午，休易坐到乔安西躺的床上，织着条根本用不着的蓝色羊毛披肩，已经无忧无虑。	Normal 30 32 披肩
坐在最末一排的一个男孩站起来，他低着头，一声不响，恼火地盯着笑得前仰后合的同桌。	Normal 28 29 盯
城中军营里，税关局长公馆，河街上一些大字号，莫不预先截老毛竹筒，或镂空棕榈树根株，用洞硝拌和磺炭钢砂，一千捶八百捶把烟火做好。	Normal 10 12 公馆
不要认为岩石是坚固不坏的，它无时无刻不经受着从各方面来的“攻击”：炎热的阳光烘烤着它，严寒的霜雪冷冻着它，风吹着它，雨打着它……	Normal 4 6 岩石
“男爵爱卿，”他厉声言道，“朕想卿也明白，‘陛下’这个称呼在全国范围内只属于孤家一人，再没有旁人称得起‘陛下’了！	Hard 3 5 爱卿
老军都点见了堆数，又引林冲到草厅上。	Normal 11 13 林冲
也许是告我的状，反正听了它的一番陈述，灰喜鹊们纷纷声色俱厉地指责起来。	Normal 8 10 反正
1997年6月30日午夜至7月1日凌晨，香港会议展览中心灯火辉煌，举世瞩目的中英两国政府香港政权交接仪式在这里的五楼大会堂隆重举行。	Normal 58 61 大会堂
后来，年级递升，成为高班生了，往住冒着被训斥的风险，闯进教员体息室去。	Normal 28 30 教员
在此顺便说一句，我酷爱古典诗词，但能够从头背到底的，只有岳武穆的《满江红》“怒发冲冠”那一首，还有就是李易安的《声声慢》，她那几个叠字：“寻寻觅觅冷冷清清，凄凄惨惨戚戚……”	Hard 78 84 凄凄惨惨戚戚
那是一个热闹的季节，也是一个风流的季节。	Normal 4 6 热闹
我在试卷上首先写上自己的名字，再写上试题的编号“1”，经过再三考虑，又在“1”的外面加上一个括号，因而成了“（1）”。	Normal 46 48 括号
然后，蜘蛛往回爬，这根线越拉越长；当它爬到线的另一端应该固定的地方，就会用爪把线聚集拢来以使线绷紧，也像刚才一样固定在墙壁的另一端上。	Normal 59 61 墙壁
开始他觉得是那悲天悯人的老诗人在唱，渐渐地觉得母亲也在唱，唱着一种他从来没有听过的激昂的调子。	Normal 44 46 调子
而我对报纸的爱好，对新闻事业的憧憬，对一天天浓重起来了。	Normal 22 24 浓重
这使他非常的痛快，因为别的没有什么可怕的了：地名他很熟习，即使有时候绕点远也没大关系，好在自己有的是力气。	Normal 31 34 有时候
那树有一点皴皱，露出老态，但是坚固稳定，树顶像刚炸开的焰火一样繁密。	Hard 5 7 皴皱
有关“克隆人”的讨论提醒人们，科技进步是一首悲喜交集的进行曲。	Normal 27 30 进行曲
当锅中的饭已经煮熟时，河水因晒了一天太阳而开始飘起炊烟一样的热气。	Normal 30 32 热气
也许，奔腾不息的浪花会把他的骨灰送往祖国的万里海疆；也许，奔腾不息的浪花会把他的骨灰送往澳门、香港；也许，奔腾不息的浪花会把他的骨灰送往宝岛台湾；也许，奔腾不息的浪花会把他的骨灰送向太平洋、印度洋、大西洋……	Normal 68 70 宝岛
将来，也许会有地心飞船找到‘落日六号’并同它对接，但愿那时我留下的资料会有用。	Hard 22 24 对接
前面我只是平铺直叙地介绍了一下飞蝗泥蜂的捕猎过程，现在我们在这种令人叹为观止的战术上花点儿时间吧。	Normal 20 22 捕猎
请堂上运用权力，把法律稍为变通一下，犯一次小小的错误，干一件大大的功德，别让这个残忍的恶魔逞他杀人的兽欲。	Normal 11 13 稍为
夜雨中，人生和历史都在蹒跚。	Normal 4 6 人生
肚子里先有了这三个人作了底子，然后再把陶渊明、应玚，谢、阮、庾、鲍等人的一看。	Hard 30 31 庾
你只听我说，你若真心要学，我这里有《王摩诘全集》，你且把他的五言律读一百首，细心揣摩透熟了，然后再读一二百首老杜的七言律，次再李青莲的七言绝句读一二百首。	Normal 8 10 真心
我大姨妈及妈妈相偕下班回家，看见一个小妖精在大门口跳橡皮筋，满头万国旗飞舞，先是前俯后仰，及看清是我，差点背过气去。	Hard 7 9 相偕
像有一只巨人的手拿着明晃晃的大刀在外边想挑破那灰色的幔，像是这巨人已在咆哮发怒;越来越紧了，一闪一闪满天空瞥过那大刀的光亮，隆隆隆,幔外边来了巨人的愤怒的吼声!	Normal 77 79 吼声
一个人对于自己的职业不敬，从学理方面说，便是亵读职业之神圣；从事实方面说，一定把事情做糟了，结果自己害自己。	Hard 22 24 亵读
休息够了，一队黑狗子先走，想从小路走上峁去。	Hard 19 20 峁
威尔莫特等学者先给苏格兰黑面羊注射促性腺素，促使它排卵。	Hard 17 21 促性腺素
江理以“从者七人，二僧与俱”，组成一支浩浩荡荡的登山队，“一仆前持斧斤，剪伐丛莽，一仆鸣金继之，二三人肩糗执剑戟以随。”	Hard 4 8 从者七人
那汉赶将去，只见这边一个客人从松林里走将出来，手里拿一个瓢，便来桶里舀了一瓢酒。	Normal 6 8 只见
“也是，岁数不饶人哪！”	Normal 9 10 哪
靠外的一面则用砖砌成高近两米的垛口。	Hard 15 17 垛口
“进士致身卿相为社会心理群趋之鹄的”，这跟科举考试有很大的关系，即汉魏以来中国古代知识人的地位大幅度上升有很大的关系，跟唐代的国力有很大的关系，这是中国文化的复兴之象。	Hard 3 7 致身卿相
宇宙是一个大生命，我们是宇宙大气中之一息。	Hard 18 20 一息
付钱出门，我刷着肩膀上的乱发对自己说，老兄，你真够机敏，总算节省了刷发屑的钱！……	Normal 0 2 付钱
细末里头不免掺和着铁臼上磨下来的铁屑，他们利用吸铁石除掉它。	Hard 9 11 铁臼
阿依穆罕大娘还用糜米放在瓦罐里，做出了一种既像黄酒、又像啤酒、也像喀瓦斯、还像哈萨克夏牧场的酸马奶一样的叫做“泡孜”的饮料，喝上一口，酸、苦、甜、凉、热俱全，我也很喜欢。	Hard 8 10 糜米
说着，只见惜春打发了入画来请宝玉，宝玉方去了。	Normal 10 12 入画
有弗学，学之弗能弗措也；有弗问，问之弗知弗措也；有弗思，思之弗得弗措也；有弗辨，辨之弗明弗措也；有弗行，行之弗笃弗措也。	Hard 16 23 问之弗知弗措也
因为他身上穿的还是那样一种浅蓝的土靛染的粗布裤褂。	Hard 16 18 土靛
他安静地听着，当照例被问及是否有话说时，牛虻只是不耐烦地挥挥手，便把事情了结了。	Hard 20 22 牛虻
她佝偻着腰，衣衫褴褛，苍白的头发在风中飘荡。	Normal 14 16 头发
我家楼梯扶手是整根的光亮的圆木，下楼时便一条腿跨上去，“哧溜”一下滑到底。	Normal 16 18 下楼
文公解释说：“雍季所说的，关系到百年大计；偃的策略，只是为了时之利，我们怎么能认为一时之利要比百年大计重要呢？”	Hard 21 22 偃
传说远古时候，在遥远的北海有一条特别大的鱼，它的名字叫作鲲。	Hard 28 29 鲲
他疑惑地自语道。	Normal 1 3 疑惑
语调，是有声语言特有的要素，其丰富的表达功能，光是文字加上标点符号是无法实现的。	Normal 23 25 光是
德国人开始感觉到运输机的日益增长的困难。	Normal 5 7 感觉
在朝旭未露前，宛似无量数厚毳长绒的绵羊，交颈接背地眠着，卷耳与弯角都依稀辨认得出。	Hard 12 14 厚毳
对当时司法部所谓的“又紧又牢的捆绑”，伽西莫多连眉毛都没有抬一下，他认为一切反抗都是徒然的，这就是说，绳子和皮条一直陷进他的肉里去了，何况监狱和囚犯这种传统还没有丢失，脚镣手铐（还有徒刑和断头台）至今依旧宝贵地在我们这些文明的温和的有人性的人中间传下去。	Normal 58 60 陷进
在其他体系建筑中，屋顶素来是不受重视的部分，除掉穹窿顶得到特别处理之外，一般坡顶都是草草处理，生硬无趣，甚至用女儿墙把它隐藏起来。	Normal 9 11 屋顶
这样我就能够拍下好几百张由反物质留在云室中的精美照片。	Hard 18 20 云室
一丈青大娘火了起来，挽了挽袖口，手腕子上露出两只叮叮当当响的黄铜镯子，一阵风冲下河坡，阻挡在这几个纤夫的面前，手戳着他们的鼻子说：“不能叫你们腌臜了我们大姑娘小媳妇的眼睛！”	Normal 13 15 袖口
他终于从巴扎诺娃ロ中了解到了真实病情：应当有思想准备，将来他还会遇到更可怕的事。	Normal 35 37 可怕
我更高兴的更安慰的是：多少过分的谀诃与夸奖，都没有使你丧失自知之明，众人的掌声、拥抱，名流的赞美，都没有减少你对艺术的谦卑！	Hard 16 18 谀诃
这么多的狮子，姿态不一，没有哪两只是相同的。	Normal 4 6 狮子
最壮是塞外点兵，吹角连营，夜深星阑时候，将军在挑灯看剑，那灯笼上你不希望写的几个斗方大字是霍嫖姚，是汉将李广，是唐朝裴公吗？	Normal 42 44 大字
可是，没一会儿，它飞起来了，红色的长嘴里衔着一条小鱼。	Normal 18 20 嘴里
江理以“从者七人，二僧与俱”，组成一支浩浩荡荡的登山队，“一仆前持斧斤，剪伐丛莽，一仆鸣金继之，二三人肩糗执剑戟以随。”	Hard 9 13 二僧与俱
当天傍晚，毛主席率领全体政协委员为纪念碑举行了庄严隆重的奠基礼，毛主席亲自执锨铲土，为纪念碑奠定基石。	Hard 28 31 奠基礼
即使这儿只是上游，还没有具有一泻千里的规模，但它那万马奔腾、浊浪排空的气概，足以使人胆惊心悸。	Normal 38 40 足以
惟有朱子解的最好，他说：“主一无适便是敬。”	Normal 6 8 最好
在江西省瑞金城外，有个叫沙洲坝的小村子。	Normal 6 8 城外
哈姆莱特那不过是一种傻气的心理；可是一个女人也许会因为这种莫名其妙的疑虑而惶惑。	Normal 20 22 女人
有时候我听着他一阵阵接连不断地咳嗽，真替他难受。	Normal 21 23 难受
宝玉听了，登时发作起痴狂病来，摘下那玉，就狠命摔去，骂道：“什么罕物，连人之高低不择，还说‘通灵’不‘通灵’呢！	Hard 32 34 罕物
这时候，她就梦想到那些精美的晚餐，亮晶晶的银器；梦想到那些挂在墙上的壁衣，上面绣着古装人物，仙境般的园林，奇异的禽鸟；梦想到盛在名贵的盘碟里的佳肴；梦想到一边吃着粉红色的鲈鱼或者松鸡翅膀，一边带着迷人的微笑听客人密谈。	Normal 53 55 奇异
“人文”这个词起源很早，《周易・责卦・彖辞》说：“观乎天文，以察时变；观乎人文，以化成天下。”	Hard 19 21 彖辞
三座大殿矗立在七米多高的白石台基上。	Hard 4 6 矗立
名人用过的东西，就是文物了，凡人用过的就是废物；名人做一点错事，写起来叫名人轶事，凡人呢，就是犯傻；名人强词夺理，叫做雄辩，凡人就是狡辩了；名人跟人握握手，叫做平易近人，凡人就是巴结别人了；名人打扮得不修边幅，叫真有艺术家的气质，凡人呢，就是流里流气的；名人喝酒，叫豪饮，凡人就叫贪杯；名人老了，称呼变成王老，凡人就只能叫老王。	Normal 29 31 错事
别人有的我都不稀罕，可我有的，别人却永远无法得到，我得到了一个天下最好的爸爸的爱。	Normal 36 38 爸爸
凡是把船划到前面一点的，必可在税关前领赏，一匹红、一块小银牌，不拘缠挂到船上某一个人头上去，都显出这船合作努力的光荣。	Normal 47 49 显出
时候既然是深冬；渐近故乡时，天气又阴晦了，冷风吹进船舱中，呜呜的响，从蓬隙向外一望，苍黄的天底下，远近横着几个萧索的荒村，没有一些活气。	Normal 49 51 远近
很久很久以前，洪水经常泛滥。	Normal 7 9 洪水
我回到堂前，看见中堂挂着的立轴──吴昌硕描的墨竹，似觉更有意味。	Hard 8 10 中堂
那后来的冰赶上他，只挤得嗤嗤价响。	Hard 12 16 嗤嗤价响
城春草木深，孟夏草木长。	Hard 6 10 孟夏草木
是什么东西让蟋的三对脚活动起来的呢？	Hard 6 7 蟋
有一天放学回家，看到天边的夕阳正要沉落，晚霞一道一道从山谷升起。	Normal 10 12 天边
更羸说：“我可以试一下。”	Hard 0 2 更羸
心中想着，忽见丫鬟话未报完，已进来了一位年轻的公子：头上戴着束发嵌宝紫金冠，齐眉勒着二龙抢珠金抹额；穿一件二色金百蝶穿花大红箭袖，束着五彩丝攒花结长穗宫绦，外罩石青起花八团倭缎排穗褂；登着青缎粉底小朝靴。	Hard 86 88 倭缎
1929年2月12日，伍若兰在赣州英勇就义。	Hard 15 17 赣州
而笼子里换上了一只小豹，即使感觉最迟钝的人看到在弃置了如此长时间的笼子里，这只凶猛的野兽不停地蹦来跳去，他也会感到赏心悦目，心旷神怡。	Normal 33 35 笼子
萨克斯管吹奏的《泰坦尼克号》的音乐，这时候适逢其时地在放着。	Normal 4 6 吹奏
爸爸竟然也说不出它是什么树，一会儿说是“桧树”，一会又说恐怕是“槭树”，都是奇怪的名称；他只说他小时候就经常来爬它，他们那群小孩子管它叫“大不列颠”，真是莫名其妙。	Hard 20 22 桧树
如文章快结束时，有没有必要引用梁元帝《采莲赋》中那么长段质量并不见佳的赋体骈文呢？	Hard 35 39 赋体骈文
这里绿树成阴，鲜花遍地。	Normal 9 11 遍地
小二黑从小就聪明，像那些算属相、卜六壬课、念大小流年或“甲子乙丑海中金”等口诀，不几天就都弄熟了，二诸葛也常把他引在人前卖弄。	Hard 16 20 卜六壬课
再进去，太和门和太和殿、中和殿、保和殿成为一组“前三殿”与乾清门和乾清宫、交泰殿、坤宁宫成为一组的“后三殿”的大同小异的重复，就更像乐曲中的主题和“变奏”；每一座的本身也是许多构件和构成部分（乐句、乐段）的重复；而东西两侧的廊、庑、楼、门，又是比较低微的，以重复为主但亦有相当变化的“伴奏”。	Hard 114 115 庑
一辆马车把他撞倒了，从他身上轧了过去。	Hard 14 15 轧
我惴惴地仰起脸望着母亲。	Normal 9 11 母亲
甚么人看了我这个记载，若神往于香草香花的沅州，居然从桃源包了小船，过沅州去，希望实地研究解决《楚辞》上几个草木问题，到了沅州南门城边，也许无意中会一眼瞥见城门上有一片触目黑色。	Normal 77 79 城门
“人文”这个词起源很早，《周易・责卦・彖辞》说：“观乎天文，以察时变；观乎人文，以化成天下。”	Hard 30 34 以察时变
千佛山、大明湖和趵突泉，是济南的三大名胜，现在单讲趵突泉。	Hard 8 11 趵突泉
九色鹿和白鸟听了，一齐劝他好生回去，免得父母、儿女担忧。	Normal 18 20 免得
至如梁、柱、枋、標、门、窗、墙、瓦、植、阶、栏杆、隔扇、斗拱、正脊、垂脊、正吻、戗兽、正房、厢房、游廊、庭院、夹道等等。	Hard 28 30 斗拱
嗉囊装满后，它用喙尖抓抓脚底，用沾着唾液的爪擦擦脸和眼睛，然后闭着双眼或者躺在沙上消化食物。	Hard 0 2 嗉囊
我双脚够不着底，身子像铅块般地往下坠，只觉得眼前金花乱冒，耳朵里嗡嗡作响，脑袋涨得几乎要炸，水还一个劲往嘴里涌。	Normal 48 51 一个劲
在荷叶底下，石头缝里，旮旮旯旯，不知还隐藏着多少骨朵，都是在岸边难以看到的。	Hard 11 15 旮旮旯旯
毛泽东淡漠的两眼却燃起了火，那是停止思考的特征。	Normal 18 20 思考
经过郊区，我闻到刺鼻的化学品烯燃烧的气味，湾里的小商人焚烧电缆。	Hard 14 15 烯
我这熊熊地燃烧着的生命，我这快要使我全身炸裂的怒火，难道就不能迸射出光明了吗？	Normal 23 25 怒火
它没有婆娑的姿态，没有屈曲盘旋的虬枝。	Hard 3 5 婆娑
中国古代哲人早就看到大自然运行的一条重要规律，并由此引申出人生的准则：“天行健，君子以自强不息。”	Hard 36 39 天行健
鬼子又抽出一只手来，在雨来的脸上打了两巴掌，又把他脸上的肉揪起一块，咬着牙拧。	Normal 0 2 鬼子
鲁达看时，只见郑屠挺在地下，口里只有出的气，没了入的气，动弹不得。	Hard 7 10 郑屠挺
小女孩向画片伸出手去。	Hard 4 6 画片
于是我重又产生了那种想法：说不定，爷爷的毡靴就是永远不会完结。	Hard 20 22 毡靴
三个圆券门上方，镌刻着“民族”、“民权”、“民生”六字，室内有12根黑色花岗石圆柱，护壁为黑色大理石，左右壁上刻有中山先生的《国民政府建国大纲》全文。	Hard 8 10 镌刻
将军既帝室之胄，信义著于四海，总揽英雄，思贤如渴，若跨有荆、益，保其岩阻，西和诸戎，南抚彝、越，外结孙权，内修政理；待天下有变，则命一上将将荆州之兵以向宛洛，将军身率益州之众以出秦川，百姓有不箪食壶浆以迎将军者乎？	Hard 10 12 著于
这些朱砂的，丹红的，紫霭色的群峰，前拥后簇，高矮参差。	Hard 10 12 紫霭
在随后的发育中，手指开始慢慢成长，手指之间的蹼渐渐退化。	Hard 22 23 蹼
例如《诗经·鲁颂》的《駉》这一首诗里提到马的名称就有16种：“驈”(身子黑而胯下白的)，“皇”(黄白相间的)，“骊”(纯黑色的)，“黄”(黄而杂红的)，“骓”(青白杂的)，“駓”(黄白杂的)，“騂”(红黄色的)，“骐”(青黑成纹像棋道的)，“驒”(青黑色而有斑像鱼鳞的)，“骆”(白马黑鬃)，“駵”(红马黑鬃)，“雒”(黑马白鬃)，“駰”(灰色有杂毛的)，“騢”(红白杂毛的)，“驔”(小腿长白毛的)，“鱼”(两眼旁边毛色白的)。	Hard 77 78 骓
随后，工作进入了设计期，他们要计算常人难以想象的庞大烦琐的数字，而当时用的只是手摇计算机。	Hard 39 41 手摇
它却默默地长上来了。	Normal 6 8 上来
休易与乔安西两人的画室就是在这胡同区里一栋矮墩墩的三层砖房的顶层。	Normal 9 11 画室
《诗·召南·草虫》说：“喓喓草虫，趯趯阜螽。”	Hard 12 16 喓喓草虫
徽曰：“孔明与博陵崔州平、颍川石广元、汝南孟公威与徐元直四人为密友。	Hard 19 22 汝南孟
至如梁、柱、枋、標、门、窗、墙、瓦、植、阶、栏杆、隔扇、斗拱、正脊、垂脊、正吻、戗兽、正房、厢房、游廊、庭院、夹道等等。	Hard 6 7 枋
野生状态中，在阳光强烈的地方，红、橙、黄花反射了热效应大的长光波，不致引起灼伤，有保护的作用。	Hard 24 27 热效应
走过月光闪闪的溪岸，走过石拱桥;走过月影团团的果园，走过庄稼地和菜地……	Normal 3 6 光闪闪
而当日出日没之际，在晨烟夕雾的迷蒙中，城犹潜蛇，山若伏鳖，馆阁楼台，隐约参错，远峰近树，依稀可辨，人们又好像面对着大幅的泼墨山水。	Normal 54 56 面对
那些戴旧毡帽的大清早摇船出来，到了埠头，气也不透一口，便来到柜台前面占卜他们的命运。	Hard 17 19 埠头
少焉，月出寒阴，微明散布石上，松声倏然自万壑来，客皆悚视寂，觉境愈清，思愈远。	Hard 15 23 松声倏然自万壑来
他们换了四回手，渐望见依稀的赵庄，而且似乎听到歌吹了，还有几点火，料想便是戏台，但或者也许是渔火。	Normal 5 7 回手
在米质好和坏的辩论之中，在斛子浅和满的争持之下，结果船埠头的敞口船真个敞口朝天了；船身浮起了好些，填没了这船那船之间的空隙的菜叶和垃圾就看不见了。	Normal 33 35 真个
在这种无动于衷的简单应对背后有他逐渐强化起来的决心。	Normal 10 12 应对
来到塘边，只见满塘浮光跃金，如繁星闪烁。	Hard 9 13 浮光跃金
荷兰侵略者惊恐万状，他们利用传教士四处活动，散布谣言，说郑成功的军队要抢粮食，挑拨汉族和高山族的关系，破坏郑成功军队和台湾各族人民的团结。	Hard 14 17 传教士
这篇敷文有更深的含ス。	Hard 2 4 敷文
水要喷出来，或者身体哪里破了流血，它立即上去按住；护士给病人打针时它要负责把注射液推入人体；握扫帚把柄时，它要独当一面；攥、捏、握、捻、弹、揪都离不开它。	Hard 66 67 捻
二人对坐于林间石上，关、张侍立于侧。	Hard 13 17 侍立于侧
悲痛，悲痛，夹杂着隐忍的积忿。	Hard 12 14 积忿
1983年的冬天，大雪纷飞，有两个旅行者来到了这个山谷。	Normal 25 27 山谷
每逢读书时，你就走出自己的心灵，进入另外一个人的心灵中，倾听另一个人的心声。	Normal 35 37 心声
自然，也可以扩大精神，增加智识的，但这些倒都不计及，一计及，便等于意在赢钱的博徒了，这在博徒之中，也算是下品。	Hard 27 29 计及
最后一句话，震撼了在座所有人的心。	Normal 0 2 最后
说罢，婆媳两个都来坐着吃了饭。	Normal 9 10 坐
所有黄皮肤的男人女人和他们的后人，都把这巨树唤作轩辕柏。	Normal 6 8 男人
元英宗十分向往贞观年间君臣相得的情景，问身边的大臣拜住：“今天可还有魏徵那样敢说话的人？”	Hard 25 27 拜住
中小户人家，忌讳较少，遇到产妇胎位不正，老娘束手，老娘就会建议：“去请陈小手吧。”	Hard 22 24 束手
他选了一群特别圈定的随员棗其中包括已经去看过的那两位诚实的大臣。	Hard 12 13 棗
凤姐夹了些茄鲞送入刘姥姥口中，笑道：“你们天天吃茄子，也尝尝我们这茄子，弄得可口不可口。”	Hard 5 7 茄鲞
嗅嗅闻闻，那冷雨。	Normal 5 8 那冷雨
在米质好和坏的辩论之中，在斛子浅和满的争持之下，结果船埠头的敞口船真个敞口朝天了；船身浮起了好些，填没了这船那船之间的空隙的菜叶和垃圾就看不见了。	Hard 13 15 斛子
但他知道明朝大势已去，就召集手下众将，说：“吾誓以身殉城！”	Hard 23 28 誓以身殉城
我觉得这和我们汉族的习俗差不多，尊老爱幼，珍重友情，和睦相处是中华民族的共同特点。	Normal 10 12 习俗
于是饥饿艺术家只得听任一切摆布：他的脑袋耷拉在胸前，就好像它一滚到了那个地方，就莫名其妙地停住不动了；他的身体已经掏空；双膝出于自卫的本能互相夹得紧紧，但两脚却擦着地面，好像那不是真实的地面，它们似乎在寻找真正可以着落的地面；他的身子的全部重量(虽然非常轻)都落在其中一个女士的身上，她气喘吁吁，四顾求援(真想不到这件光荣差事竟是这样的)，她先是尽量伸长脖子，这样至少可以使饥饿艺术家碰不到她的花容。	Normal 175 177 伸长
据说当时曾用狼粪来作燧，因为狼粪的烟可以直上云霄，远处容易看见，所以又称烽火台为狼烟台。	Normal 29 31 看见
此时已经聚集了几个人，便和掌柜都笑了。	Normal 4 6 聚集
夏天，我们喜欢自己做抄网，去河边捉小鱼和小虾。	Hard 10 12 抄网
黄翅飞蝗泥蜂在杀死蟋蟀时无疑是使出了最高明的手段的，所以有必要看看它是怎样杀死猎物的。	Hard 2 6 飞蝗泥蜂
那计较都是吴用主张，这个唤作“智取生辰纲”。	Hard 17 20 生辰纲
突然，远处海面上隐隐约约传来断断续续的歌声。	Normal 3 5 远处
这样小题大做反把朗丹先生弄得很不自在，他张嘴正要说：“噢！	Normal 20 22 张嘴
一天傍晚，海娃腰里插着羊鞭，拿着一杆红缨枪，在山上的一棵小树底下放哨。	Normal 2 4 傍晚
和风吹送，翻起了一轮一轮的绿波，——这时你会真心佩服昔人所造的两个字“麦浪”，若不是妙手偶得，便确是经过锤炼的语言的精华。	Normal 22 24 真心
马俑与真马一般大小，一匹匹形体健壮，肌肉丰满。	Normal 10 12 一匹
清清的泉水从井底汩汩地冒出来，人们欢呼雀跃，争先恐后地捧起井水喝。	Hard 8 10 汩汩
像有一只巨人的手拿着明晃晃的大刀在外边想挑破那灰色的幔，像是这巨人已在咆哮发怒;越来越紧了，一闪一闪满天空瞥过那大刀的光亮，隆隆隆,幔外边来了巨人的愤怒的吼声!	Normal 37 39 发怒
我这位于勒叔叔一到那里就做上了不知什么买卖，不久就写信来说，他赚了点钱，并且希望能够赔偿我父亲的损失。	Normal 19 21 买卖
“吹面不寒杨柳风”，不错的，像母亲的手抚摸着你。	Hard 1 8 吹面不寒杨柳风
“这也是很早以前的事，也是发生在贝加尔湖的那片沼泽地。	Normal 13 15 发生
第一节课上，他问我们：“谁知道一种叫做凯蒂旺普斯的动物？”	Normal 17 19 叫做
例如《诗经·鲁颂》的《駉》这一首诗里提到马的名称就有16种：“驈”(身子黑而胯下白的)，“皇”(黄白相间的)，“骊”(纯黑色的)，“黄”(黄而杂红的)，“骓”(青白杂的)，“駓”(黄白杂的)，“騂”(红黄色的)，“骐”(青黑成纹像棋道的)，“驒”(青黑色而有斑像鱼鳞的)，“骆”(白马黑鬃)，“駵”(红马黑鬃)，“雒”(黑马白鬃)，“駰”(灰色有杂毛的)，“騢”(红白杂毛的)，“驔”(小腿长白毛的)，“鱼”(两眼旁边毛色白的)。	Hard 157 158 雒
时间过得那么飞快，我的小心眼里不只着急，而且悲伤。	Normal 22 24 悲伤
随后就可以听到一阵喉音，以及趿拉着木皮拖鞋踏在窄狭木楼梯的踢踏声；他终于站在来客的面前，上身没有穿外衣，背有点儿弯，腰间围着皮围裙，袖子往上卷起，眼睛眨动着——像刚从靴子梦中惊醒过来，或者说，像一只在日光中受了惊动因而感到不安的猫头鹰。	Hard 14 16 趿拉
新式构造，用不着争座位，便放了心，延宕到九点钟才去，谁料照例，人都满了，连立足也难，我只得挤在远处的人丛中看一个老旦在台上唱。	Hard 17 19 延宕
“他多年出门，统忘却了。	Hard 7 8 统
城破时，史可法要拔刀自刎，手下众将争着抱住他，史可法大声呼史德威动手，史德威泪如雨下，不能举刀。	Hard 10 12 自刎
可是，在自然看来，人类上下翻飞的这片巨大空间，不过是咫尺之间而已，就如同鲲鹏看待斥鴳一般，只是蓬蒿之间罢了。	Hard 36 38 鲲鹏
极天云一线异色，须臾成五采。	Hard 0 3 极天云
山东黄河结冰是何情状？	Normal 4 6 结冰
那只大虫咆哮着，发起性来，翻身又扑起来。	Hard 8 12 发起性来
它巍巍然撑立在高原之上，给人以生命伟力的强大感召。	Normal 9 11 之上
由于另一条鲨鱼正在蹂躏死鱼的缘故，船身还在晃荡，老头儿松开了帆脚绳，让船向一边摆动，使鲨鱼从船底下出来。	Hard 9 11 蹂躏
“大婶子，别撕了，放到这时候的白菜，老帮子脱了五六层，成了核了。”	Hard 18 21 老帮子
杨志却要辰牌起身，申时便歇。	Normal 6 8 起身
老板见了这件首饰，就立刻叫了起来：	Normal 0 2 老板
理智上，我知道我的头发不比使用香波前干净多少——尘土能到哪里去？——	Hard 15 17 香波
那弯弯曲曲的小道穿过茂密的白桦林，穿过杂草丛生的空地，又爬到长满云杉的小山上去了。	Normal 6 8 小道
“不可上，乃止”，他们没上去。	Hard 5 7 乃止
父亲有时吸点旱烟，喝点酒；母亲管束着我们，不允许我们染上一点。	Normal 13 15 母亲
放眼望去，绿意盎然，受到市民的普遍称赞。	Normal 12 14 市民
我也不过吃了饭就过来，你到午错的时候来领银子，后儿就进去种花儿。	Hard 13 15 午错
经度之所以发生影响，是离海洋远近的关系。	Normal 14 16 远近
两个教头就在月光下一来一往，交起手来。	Hard 2 4 教头
只是它的联想的意义迷离不易捉摸，它可以联想到燃烧弹，鸦片烟榻，庙里焚香，“一川烟水”，“杨柳万条烟”，“烟光凝而暮山紫”，“蓝田日暖玉生烟”……	Hard 62 69 蓝田日暖玉生烟
自既望以至十八为最盛。	Hard 1 3 既望
波农丁皱着眉头，伤感地说：“它要离开我们去象冢了。”	Hard 21 23 象冢
他站住了，脸上现出欢喜和凄凉的神情；动着嘴唇，却没有作声。	Normal 9 11 欢喜
汽车行驶了大约三英里时，我们发现路边有条大黄狗，它似乎等着我们的到来。	Normal 16 18 路边
终于,四只活泼的小朱鹮钻出蛋壳,来到世界上。	Hard 9 11 朱鹮
它的眼睛闪闪有光，并且目光十分坦率；它的耳朵也长得好，并且不大不小，不像牛耳太短，驴耳太长；它的鬣毛正好衬着它的头，装饰着它的颈部，给予它一种强劲而豪迈的模样；它那下垂而茂盛的尾巴覆盖着、并且美观地结束着它的身躯的末端：马尾和鹿、象等的短尾，驴、骆驼、犀牛等的秃尾都大不相同，它是密而长的鬃毛构成的，仿佛这些鬃毛就直接从屁股上生长出来，因为长出鬃毛的那个小肉桩子很短。	Hard 48 50 鬣毛
突然，小伙伴“哎哟”一声叫起来，原来是螃蟹用大螯夹住了他的手。	Hard 22 24 大螯
千余年来读书人对于桃源的印象，既不怎么改变，所以每当国体衰弱发生变乱时，想做遗民的必多，这文章也就增加了许多人的幻想，增加了许多人的酒量。	Normal 56 58 幻想
有弗学，学之弗能弗措也；有弗问，问之弗知弗措也；有弗思，思之弗得弗措也；有弗辨，辨之弗明弗措也；有弗行，行之弗笃弗措也。	Hard 28 35 思之弗得弗措也
自从古人写了一句“桂林山水甲天下”的诗，多有把它当做品评山水的论断。	Hard 13 16 甲天下
它那带锯齿的大腿被黄翅飞蝗泥蜂的前足压住，无法发挥进攻性武器的作用，它的双颚被飞蝗泥蜂的后腿顶得离开老远，虽然张得大大的，咄咄逼人，却咬不到敌人的任何部位。	Hard 36 38 双颚
那幔比以前加倍厚！	Normal 3 5 以前
暗礁们甚至呼求狂风暴雨一起来扑灭灯塔，更祈望闪电猛雷把灯塔粉身碎骨。	Normal 3 5 甚至
根据这个传说，人们用“杏林”称颂医生，用“杏林春满”或“誉满杏林”等成语来赞扬医生的高明医术和高尚医德。	Normal 44 46 医术
毛泽东：“和你们坐在一起的还有大文学家成仿吾、冯雪峰、李一氓等同志。	Normal 0 3 毛泽东
周瑞家的命雇的小丫头倒上茶来吃着。	Hard 5 6 雇
他坐在你的对面、毫无卖弄意味地与你侃侃而谈，你则不断被这样一个事实所叹服：你面对的的确是一个美国人，但这人的确说着类似中国标准播音员的标准汉语——如果说与播音员的标准略有不同，那是因为戴维的汉语语音比播音本身更像生活。	Normal 63 66 播音员
邻居见他不信，劈手把鸡夺了，掼在地下，一把拉了回来。	Hard 14 15 掼
第三个的话还没有说完，一旁的帘子突然拉开，一把硬币扔了出来，劈头盖脸地砸在这些人的头上、肩上。	Normal 14 16 帘子
白天，塘面在阳光下泛着绿光，在微风中漾着绿浪；绿色的荷叶铺在水面上，绿叶中点缀着许多粉红的荷苞和荷花，娇嫩而洁净的荷花颤动着，像披着青纱跳舞的少女。	Normal 54 56 洁净
这时，天空中传来了飞机的轰鸣声，白军毫不介意，知道飞机是来配合他们追赶红军的。	Normal 33 35 追赶
两岸连山，略无阙处。	Hard 0 4 两岸连山
同父亲作用紧密相关的是另一个同社会经济发展有关的作用，随着私有制以及财产由一个儿子继承的现象出现，父亲就对那个将来要继承他财产的人特别感兴趣。	Normal 55 57 将来
这一对烁烁发光的晶体具有足够的热量和纯度，能够忘我地注视上帝；有足够的勇气注视摧毁一切的虚无，这种虚无犹如蛇发女怪那样，看到她的人就会变成石头。	Normal 18 20 纯度
惟有朱子解的最好，他说：“主一无适便是敬。”	Hard 13 20 主一无适便是敬
这些泉有的白浪翻滚，好像银花盛开；有的晶莹剔透，好像明珠散落；有的声音洪大，听起来如虎啸狮吼；有的声音低细，听起来如秋雨潇潇。	Normal 7 9 翻滚
及至始皇，奋六世之余烈，振长策而御宇内，吞二周而亡诸侯，履至尊而制六合，执敲扑而鞭笞天下，威振四海。	Hard 28 29 履
有诗为证:“丹崖夹石柱，菌萏金芙蓉”。	Hard 6 8 丹崖
我占据着高广不过一丈的小房间，砖铺的潮湿的地面，纸糊的墙壁和天花板，两扇木格子嵌玻璃的窗，窗上有很灵巧的纸卷帘，这在南方是少见的。	Normal 30 33 天花板
“只要他们有了火，”普罗米修斯对自己说，“他们至少就可以取暖和做饭了；他们还可以学会制造工具，给自己盖房子住。	Normal 44 46 工具
但是，传说归传说，她毕竟只是巨石一柱，险峰一座，只是自然力对人类的一个幽默安慰。	Normal 26 29 自然力
予今长斯校，请以三事为诸君告：	Hard 0 5 予今长斯校
广袤的大地是她宽广的胸怀，茂密的森林是她飘逸的长发，温暖的太阳是她明亮的眸子，和煦的轻风是她甜蜜的絮语……	Hard 49 51 絮语
水，装饰地球环境的珍珠、轻纱和彩带，无论是晶莹的水珠、雨雾云霭，还是纷纷扬扬的雪花、五彩缤纷的彩虹。	Normal 39 41 雪花
这就是为何我们要重启奥林匹克时代，并为体格训练的复兴隆重庆祝的原因。	Normal 3 5 为何
许先生用筷子来回地翻着饭桌上菜碗里的东西，菜拣嫩的，不要茎，只要叶，鱼肉之类，拣烧得软的，没有骨头没有刺的。	Normal 13 15 上菜
《红楼梦》是我在十二三岁时候看的，起初我对它的兴趣并不大，贾宝玉的女声女气，林黛玉的哭哭啼啼，都使我厌烦，还是到了中年以后再拿起这部书看时，才尝到“满纸荒唐言，一把辛酸泪”一个朝代和家庭的兴亡盛衰的滋味。	Hard 74 79 满纸荒唐言
文字虽然不是语言的如实记录，但是它必得拿语言做基础，其中有些是离语言不太远的，通过这些我们可以对古代语言的演变获得一定的认识。	Normal 17 19 必得
为此，新加坡人只建绿篱不建围墙，从1971年开始大种其树，大铺草坪，连天桥、候车棚、电线杆都攀上藤蔓，使城市环抱在绿色之中。	Normal 35 37 天桥
杀好了腰，再穿上肥腿的白裤，裤脚用鸡肠子带儿系住，露出那对"出号"的大脚！	Normal 25 27 露出
长的草里是不去的，因为相传这园里有一条很大的赤练蛇。	Hard 22 25 赤练蛇
据有考据癖的人说：这就是五通神。	Hard 2 5 考据癖
来到这座城市，展现在救援队员面前的是一片悲惨景象：房倒屋塌，失去亲人的大人、孩子在哭泣，空气中弥漫着尸体腐烂后荼发的臭气。	Hard 55 57 荼发
消灭体内细菌的战役开始于20世纪初叶，随着青霉素的发明，“抗生素时代”到来了，并且一度以为已经大获全胜。	Normal 35 37 到来
在安造垸，他们救出了被洪水围困了三天三夜的幼儿园老师周运兰；在簰州湾，他们给攀上树梢等待了近九个小时的小江珊以生的希望……	Hard 31 34 簰州湾
先在东三省立了个小宣统的满洲国，又在口外立了个德王的蒙疆政府，往后没有殷汝耕的公文护照，不许出口一步。	Hard 8 11 小宣统
华罗庚扬了扬手中的报纸，“这一天总算盼到了！”	Normal 16 18 总算
在阳光明丽的中午，还可以看到水底一群群的游鱼，一动不动地正儿八经停在那儿，好像待命出发的潜艇队伍。	Normal 34 36 那儿
后生们也忙着，不时射出一道道手电筒的光束，照到了不远处的少女堆里，照在某一张脸上，于是招来破口大骂，是“三狗子你照你娘呵”一类，引得少女们开心大笑，挨骂的后生们也浪浪地乐不可支。	Normal 14 17 手电筒
由于遭受超量的放射性辐射，邓稼先患了癌症，与1986年7月29日与世长辞。	Normal 4 6 超量
等它吃过一口饭，踏着方步去喝水、吃泥、吃草的当儿，狗就敏捷地跑过来，努力地吃它的饭。	Hard 10 12 方步
那条白线很快地向前移动，逐渐拉长，变粗，横贯江面。	Normal 14 16 拉长
“神女”一词终于由瑰丽走向淫邪，无论哪一种都与健全的个体生命相去遥遥。	Normal 1 3 神女
邢夫人苦留吃过晚饭去，黛玉笑回道：“舅母爱惜赐饭，原不应辞，只是还要过去拜见二舅舅，恐领了赐去不恭，异日再领，未为不可。	Hard 25 29 原不应辞
香菱笑道：“我只爱陆放翁的诗‘重帘不卷留香久，古砚微凹聚墨多’，说的真有趣！”	Hard 15 22 重帘不卷留香久
但他现在除了用大手去抚慰儿子，也别无他法。	Normal 4 6 除了
他总算还保住了那个白铁罐子。	Normal 4 6 保住
这个人打扮与众姑娘不同，彩绣辉煌，恍若神妃仙子：头上戴着金丝八宝攒珠髻，绾着朝阳五凤挂珠钗；项下戴着赤金盘螭璎珞圈；裙边系着豆绿宫绦双鱼比目玫瑰佩；身上穿着缕金百蝶穿花大红洋缎窄裉袄，外罩五彩刻丝石青银鼠褂，下罩翡翠撒花洋绉裙。	Hard 52 57 盘螭璎珞圈
有时他不了了之，引得你遥思远怅：“美人卷珠帘，深坐颦蛾眉；但见泪痕湿，不知心恨谁。”	Normal 0 2 有时
来自西伯利亚的寒流经常气势汹汹地掠过这片海域。	Normal 7 9 寒流
有一只水生小甲虫，像铜一样亮闪闪，在平静的水上打转。	Normal 11 13 一样
不过，简短的诗可以有悠远的意味，收缩并不妨碍延长，仿佛我们要看得远些，每把眉眼颦蹙。	Hard 39 41 颦蹙
在这以前，爱因斯坦决心关起门来搞统一场论。	Normal 5 9 爱因斯坦
我眺望四周，一片茫无边际的蔚蓝的海，无数波浪闪耀着金鳞；头上，也是这样茫无边际，这样蔚蓝的海——在那儿，温柔的太阳在运行着，宛然在微笑。	Hard 25 27 金鳞
《诗·召南·草虫》说：“喓喓草虫，趯趯阜螽。”	Hard 17 21 趯趯阜螽
到了这个时候，诗的平仄逐渐有了定格。	Hard 9 11 平仄
开船以后，水路中的风景，盒子里的点心，以及到了东关的五猖会的热闹，对于我似乎都没有什么大意思。	Hard 26 29 五猖会
特别值得一提的是那些笔、墨水、纸，船主、大副、炮手和木匠的几包东西，三四个罗盘，一些数学仪器，日晷、望远镜、地图、航海书籍之类。	Hard 47 49 日晷
可我们的请愿受到轻侮，我们的抗议招致了新的暴力，我们的哀求被人家置之不理，我们被人家轻蔑地一脚从御座前踢开了。	Normal 40 42 人家
他写了一百六十张，算起来值两角钱了，方才停手，把笔放在原处，熄了灯，蹑手蹑脚地回到床上去。	Normal 18 20 方才
它出来掠取粮食，它捕获到了食品，可是，此后它又做些什么呢？	Normal 19 21 此后
老师叫我们先静默再读书。	Normal 9 11 读书
在時天之下，旋风忽来，使连勃地奇飞，在日光中灿灿地生光，如色火的大雾，旋转而且升腾，弥没太空，使太空旋转而且升勝地闪烁鲁迅憎恶这使雪花永远“如粉，如沙”地旋转飞腾的方的冬天，同时又赞颂这与“凛冽的天宇”奋飞搏战的孤独而低强的“雨的精魂”。	Normal 25 27 生光
他管这种枕头叫“警枕”。	Hard 8 10 警枕
第二天的生意不错，可是躺了两天，他的脚脖子肿得象两条瓠子似的，再也抬不起来。	Hard 26 28 瓠子
天上那层灰气已散，不甚憋闷了，可是阳光也更厉害了许多：没人敢抬头看太阳在哪里，只觉得到处都闪眼，空中，屋顶上，墙壁上，地上，都白亮亮的，白里透着点红；由上至下整个的象一面极大的火镜，每一条光都象火镜的焦点，晒得东西要发火。	Normal 51 53 屋顶
过多的芬芳之气使得您头晕目眩。	Normal 7 9 使得
小松鼠问蚯蚓：“这是什么呀？”	Normal 1 3 松鼠
在克隆鲫鱼出现之前，英国牛津大学的科学家已经在1960年和1962年，先后用非洲一种有爪的蟾蜍(非洲爪蟾)进行过克隆试验。	Hard 1 5 克隆鲫鱼
杜雍和不再乱发脾气。	Normal 6 9 发脾气
他实在受不了这些人的虐待。	Normal 3 6 受不了
梁思成第一个抓住铁索，两腿悬空地往刹尖攀援。	Normal 8 10 铁索
胡早秋吓得要死，本能地在水中挣扎起来，搞得田立业益发艰难，一路上气喘吁吁，还喝了不少水。	Hard 24 26 益发
《红楼梦》是我在十二三岁时候看的，起初我对它的兴趣并不大，贾宝玉的女声女气，林黛玉的哭哭啼啼，都使我厌烦，还是到了中年以后再拿起这部书看时，才尝到“满纸荒唐言，一把辛酸泪”一个朝代和家庭的兴亡盛衰的滋味。	Hard 80 85 一把辛酸泪
德拉这样做了，可精神上的感慨油然而生，生活就是哭泣、抽噎和微笑，尤以抽噎占统治地位。	Hard 26 28 抽噎
比较早的有葡萄、苜蓿、茉莉、苹果、菠菜等等，近代的像咖啡、可可、柠檬、雪茄、巧克力、冰淇淋、白兰地、啤酒、卡片、沙发、扑克、哔叽、尼龙、法兰绒、道林纸、芭蕾舞等等，都是极常见的。	Normal 35 37 雪茄
“作善降祥”的古训，六朝人本已有些怀疑了，他们作墓志，竟会说“积善不报，终自欺人”的话。	Hard 31 35 积善不报
他穿过大街，继续朝前走，走着走着发现走错了路，又转过身来往回走，走到了杜依勒里宫，过了塞纳河，一看又走错了，于是又回到香榭丽舍大街，脑子里乱得没有一点儿主意。	Normal 1 3 穿过
鲁提辖坐了主位，李忠对席，史进下首坐了。	Hard 10 12 对席
书桌上的一盆“水横枝”，是我先前没有见过的：就是一段树，只要浸在水中，枝叶便青葱得可爱。	Hard 7 10 水横枝
那些图案，始终受到造物主的青睐，被无比耐心地绘制。	Normal 9 12 造物主
汽车行驶了大约三英里时，我们发现路边有条大黄狗，它似乎等着我们的到来。	Hard 8 10 英里
我们从一座楼梯顶上的天窗孔里下了屋。	Hard 10 13 天窗孔
据王粲的《英雄记钞》说，诸葛亮与徐庶、石广元、孟公威等人一道游学读书，三人务于精熟，而亮独观其大略。	Hard 1 3 王粲
裸子植物的花是原始的形态，都带绿色，而花药和花粉则呈黄色。	Hard 0 4 裸子植物
在病床前苦苦服侍了他数年的养母，悲声大放：“我怎么就把您服侍下个这样儿……	Hard 30 32 下个
诚然，绝不应该限制艺术的天地：应该承认复杂派、玄妙派和晦涩派存在的权利，但在我看来，这一切不过是堕落，如果你愿意的话，也可以说是一时的离经叛道，总还是必须回到纯朴派和明晰派中来的，正如人们终归还是吃那使他获得营养而永不会使他厌腻的日常必吃的面包。	Normal 94 96 终归
此游不仅自己饱饫一时眼福，还可以终久地向许多朋友夸耀呢。	Normal 8 10 一时
如有过往客商人等，可于巳、午、未三个时辰，结伴过冈。	Hard 11 12 巳
更有殷勤的，跑回来偷拿了红薯、土豆，在火堆里煨熟给演员作夜餐，赚得进屋里有一个安全位置。	Hard 22 24 煨熟
满园子的人都屏气凝神，不敢稍动。	Normal 1 3 园子
它不同于：“美女妖且闲，采桑歧路间；柔条纷冉冉，落叶何翩翩。”	Hard 6 11 美女妖且闲
他勉强一笑，说：“我一直在数你的刀数。”	Normal 10 12 一直
人们是熟悉天坛的，但是对于“圜丘”，没有到过北京的人就未必知道了。	Hard 14 16 圜丘
凤姐听了说道：“怪道既是一家子，我怎么连影儿也不知道！”	Hard 8 10 怪道
正因为大熊猫繁殖艰难，存活又难，所以如今我国野生的大熊猫已为数不多，估计只有1000只左右。	Normal 11 13 存活
它谨慎地左顾右盼，慢慢地朝着一个方向迈出了几步，随后又不放心地退了回来，往另一个方向试探。	Normal 12 14 朝着
到七月，听台风台雨在古屋顶上一夜盲奏，千寻海底的热浪沸沸被狂风挟来，掀翻整个太平洋只为向他的矮屋檐重重压下，整个海在他的蜗壳上哗哗泻过。	Normal 29 31 狂风
那些属于所谓同属的生物都是另一个并且一般是已经绝灭的物种的直系后代，这与任何一个物种的公认的变种是该物种的后代，是同样的情形。	Hard 6 8 同属
只是它的联想的意义迷离不易捉摸，它可以联想到燃烧弹，鸦片烟榻，庙里焚香，“一川烟水”，“杨柳万条烟”，“烟光凝而暮山紫”，“蓝田日暖玉生烟”……	Hard 52 59 烟光凝而暮山紫
村长在嘎羧脖子上系了一条洁白的纱巾，四条象腿上绑了四块黑布。	Hard 3 5 嘎羧
一方的异彩，揭去了满天的睡意，唤醒了四隅的明霞——光明的神驹，在热奋地驰骋。	Hard 28 30 神驹
温暖的火、喷香的米饭和滚热的洗脚水，把我们身上的疲劳、饥饿都撵走了。	Hard 30 32 撵走
不是我口浅，量你是个遭死的军人，相公可怜，抬举你做个提辖，比得草芥子大小的官职，直得恁地逞能。	Normal 37 39 官职
他们纳粮当兵，敬畏官吏，何负于晋？	Normal 9 11 官吏
但是妙就妙在哪怕是在这种严格的局限于对具体对象的描写中，由于描写是这样深刻地抓住了具体对象的特征，这种特征是这样浓重地体现了作者的内心世界，而作者的内心又是这样深刻地体现了时代和社会的矛盾；因此，这些描写就富有启发性地提供了将对象的特征重新加以结合的条件，以至于，在“雪”的后面，那种更大更深更感人的形象和思想，已经成熟到呼之欲出的地步了。	Normal 166 168 地步
进入冬季，也冬眠，只是先把花衣裳脱下来睡一小会儿，花魂是醒的。	Normal 22 24 会儿
我要看那滚滚的波涛，我要听那鞺鞺鞳鞳的咆哮，我要漂流到那没有阴谋、没有污秽、没有自私自利的没有人的小岛上去呀！	Hard 14 18 鞺鞺鞳鞳
我更高兴的更安慰的是：多少过分的谀诃与夸奖，都没有使你丧失自知之明，众人的掌声、拥抱，名流的赞美，都没有减少你对艺术的谦卑！	Normal 34 36 众人
1958年在第六届世界杯足球决赛中，巴西队首次获得冠军，全国上下一片欢腾。	Normal 9 12 世界杯
我想到了当年陪同梁思成勘探木塔的年轻学者莫宗江先生后来的回忆:他们爬到了塔顶，但塔刹还有十多米高，除了几根铁索外，没有任何可供攀援的东西。	Hard 40 42 塔刹
屋顶的坡度就随着这挙架，由下段的檐部缓和的坡度逐步增高为近屋脊处的陡斜，成了缓和的弯曲面。	Hard 9 11 挙架
但一到次子傩送年过十二岁时，已能入水闭铺氽着到鸭子身边，再忽然从水中冒水而出，把鸭子捉到，这作爸爸的便解嘲似的说：“好，这种事有你们来作，我不必再下水了。”	Hard 20 21 氽
周恩来铿锵有力的话语，博得了魏校长的喝彩：“好哇！	Normal 15 17 校长
天之涯，地之角，知交半零落，人生难得是欢聚，惟有别离多……	Hard 11 13 零落
瞻仰了史可法的衣冠冢后，西向步入史公祠，祠内挂有史可法坐像。	Normal 27 29 坐像
例如《诗经·鲁颂》的《駉》这一首诗里提到马的名称就有16种：“驈”(身子黑而胯下白的)，“皇”(黄白相间的)，“骊”(纯黑色的)，“黄”(黄而杂红的)，“骓”(青白杂的)，“駓”(黄白杂的)，“騂”(红黄色的)，“骐”(青黑成纹像棋道的)，“驒”(青黑色而有斑像鱼鳞的)，“骆”(白马黑鬃)，“駵”(红马黑鬃)，“雒”(黑马白鬃)，“駰”(灰色有杂毛的)，“騢”(红白杂毛的)，“驔”(小腿长白毛的)，“鱼”(两眼旁边毛色白的)。	Hard 179 180 騢
可是，出乎预料的是，小姑娘竟学着萧伯纳的口吻说道：“请你回去后告诉你妈妈，就说今天同你玩的是苏联小姑娘娜塔莎。”	Hard 51 54 娜塔莎
哪有酿葡萄酒还要放酒药的道理？	Hard 9 11 酒药
手术完成之后，用相同频率的电脉冲刺激换核卵，让苏格兰黑面羊的卵细胞质与芬多席特母羊乳腺细胞的核相互协调，使这个“组装”细胞在试管里经历受精卵那样的分裂、发育而形成胚胎的过程。	Normal 59 61 细胞
“年”见了桃符，听到爆竹响，吓得赶快逃跑，这样大家就安然无恙了。	Hard 5 7 桃符
有了网络，五湖四海的人随时可以交流，咱们的地球就变成了一个小村庄。	Normal 18 20 咱们
他哈哈笑着，朝我摆摆手。	Normal 1 4 哈哈笑
她说：“你的脚是汗脚，线是烂断的。	Normal 13 14 烂
离开北平一年了，我怀念着我的圆窗和绿友。	Hard 17 19 绿友
当我们从生物的世界到人类的社会，一以贯之地看待寄生策略的时候，便可望获得一种不卑不亢、不愠不火、不喜不哀的态度。	Hard 16 20 一以贯之
它的成分并不和一般通用的意义一样，里面是较少的籼米、锅焦、碎米和较多的乡下人用来喂猪的豆腐渣！	Hard 23 25 籼米
现在，人们用“舍本逐末”来比喻做事不抓住主要问题，而专顺细枝末节。	Normal 18 20 抓住
浉河依傍着家乡的城镇。	Hard 0 2 浉河
经常重视对文章结构的揣摩和修改，谋篇布局的能力自然会不断提高。	Hard 10 12 揣摩
一块灶糖，一个甜瓜，一把红枣……	Normal 12 14 红枣
秦王又手捧住璧，一边看一边称赞，绝口不提十五座城的事。	Hard 6 7 璧
不要认为岩石是坚固不坏的，它无时无刻不经受着从各方面来的“攻击”：炎热的阳光烘烤着它，严寒的霜雪冷冻着它，风吹着它，雨打着它……	Normal 33 35 炎热
在此顺便说一句，我酷爱古典诗词，但能够从头背到底的，只有岳武穆的《满江红》“怒发冲冠”那一首，还有就是李易安的《声声慢》，她那几个叠字：“寻寻觅觅冷冷清清，凄凄惨惨戚戚……”	Hard 69 77 寻寻觅觅冷冷清清
茨威格怕打扰雕塑家工作，悄悄地站在一边。	Normal 17 19 一边
卫士和警卫人员从惊愕中突然惊醒，呼啦一下围过去，想把毛泽东围在中心。	Normal 0 2 卫士
例如《诗经·鲁颂》的《駉》这一首诗里提到马的名称就有16种：“驈”(身子黑而胯下白的)，“皇”(黄白相间的)，“骊”(纯黑色的)，“黄”(黄而杂红的)，“骓”(青白杂的)，“駓”(黄白杂的)，“騂”(红黄色的)，“骐”(青黑成纹像棋道的)，“驒”(青黑色而有斑像鱼鳞的)，“骆”(白马黑鬃)，“駵”(红马黑鬃)，“雒”(黑马白鬃)，“駰”(灰色有杂毛的)，“騢”(红白杂毛的)，“驔”(小腿长白毛的)，“鱼”(两眼旁边毛色白的)。	Hard 97 98 騂
但是如果它比临界值大，宇宙就会坍缩，而时间本身就会在大挤压处终结。	Hard 15 17 坍缩
革命样板戏当然是含有意识形态的，但那些意识形态同这样的观众有什么关系吗？	Hard 2 5 样板戏
代表本地的出产，边街上有几十家玉器作，用珉石染红着绿，琢成酒杯笔架等物，货物品质平平常常，价钱却不轻贱。	Hard 20 22 珉石
姚文的“下有红光，动摇承之”十分高明，把动感表现得灵活之至。	Hard 9 13 动摇承之
“三十二个鬼子……”	Hard 5 7 鬼子
回来的路程危险增加了十倍，在前往极点的途中只要遵循罗盘的指引，而现在他们还必须顺着自己原来的足迹走去，在几个星期的行程中必须小心翼翼，绝对不能偏离自己原来的脚印，以免错过事先设置的贮藏点——在那里储存着他们的食物、衣服和凝聚着热量的几加仑煤油。	Hard 117 119 加仑
河面各只彩船上，无数五颜六色的霓虹灯、日光灯齐放光华，闪烁迷离，和水中倒影连成一片。	Hard 15 18 霓虹灯
老杜有一句诗：“四更山吐月，残夜水明楼”，后代的诗人特别喜欢。	Hard 14 19 残夜水明楼
没走多远，一个老人看见了，摇头说：“孙子骑驴，让爷爷走路，太不尊敬老人了！”	Normal 24 26 爷爷
他就到那两个狡猾的骗子所在的地方去。	Normal 9 11 骗子
“后之视今，亦犹今之视昔”，你们不久也要走这条路呢！	Hard 1 4 后之视
小羊也说：“大象啊，你的耳朵怎么是耷拉着的呢？”	Hard 17 19 耷拉
《东京梦华录》中所记述的街巷、酒楼、饮食果子，以及“天晓诸人入市”“诸色杂卖”等，都能在这画面中找到生动的图释。	Hard 34 36 诸色
而且并不使人气闷。	Normal 0 2 而且
李逵把布衫拽起在前面，口里喝道：“你们还我也不还？”	Normal 8 10 前面
一次，他被一篇小说的情节吸引了：一个英雄把被单的两个角系在一起，两手紧紧抓住，从高高的城堡跳下去，利用空气托举缓缓落地，逃离了囚禁他的地方。	Normal 21 23 被单
战斗开始后的几十分钟里，一切顺利，伤员一次次带下来的消息，都是我们突破第一道鹿砦，第二道铁丝网，占领敌人前沿工事打进街了。	Hard 38 40 鹿砦
李小二道：“官人请甚客？”	Hard 9 11 甚客
那十一个厢禁军口里喃喃讷讷地怨怅，两个虞候在老都管面前絮絮聒聒地搬口。	Normal 1 4 十一个
我已经奔流到了丽江坝放牧着牛羊的草甸上，我也要去四方街。	Normal 1 3 已经
奥别多菲尔先生，过去教马思聪兄时，每月收学费二百法郎（当时约合华币十元左右）。	Hard 24 26 法郎
另外还要个拦头工人，上滩下滩时看水认容口，出事前提醒舵手躲避石头，恶浪与洑流，出事后点篙子需要准确，稳重。	Hard 18 20 容口
家明还记得他六岁那年，叔公从美国洛杉矶回香港来，每次出外游玩，总带着他。	Hard 11 13 叔公
这时，宇航员们感到自己的身体轻飘飘的，无法在座舱里站稳，稍一抬脚，就会跳起三四米高。	Normal 0 2 这时
鞭炮放过一阵后，用长凳脚绑着的大筒烟火，在敞坪一端燃起了引线，先是咝咝的流泻白光，慢慢的这白光便吼啸起来，作出如雷如虎惊人的声音，白光向上空冲去，高至二十丈，下落时便洒散着满天花雨。	Hard 21 23 敞坪
心中想着，忽见丫鬟话未报完，已进来了一位年轻的公子：头上戴着束发嵌宝紫金冠，齐眉勒着二龙抢珠金抹额；穿一件二色金百蝶穿花大红箭袖，束着五彩丝攒花结长穗宫绦，外罩石青起花八团倭缎排穗褂；登着青缎粉底小朝靴。	Hard 75 77 宫绦
自去肉案上拣了十斤精肉，细细切做臊子。	Hard 16 18 臊子
就在我抵台的前几周，一声焦雷，从神木贯顶而下，一劈为三，中间全成枯焦。	Normal 28 30 中间
王冕不禁看得入了迷，心里想道：“古人说‘人在图画中’，真是一点不错。	Normal 22 24 图画
穿在身上的100多磅重的铠甲，只能部分地分散我身上的负重。	Hard 9 10 磅
两人吃完饭坐在屋里，因屋前滨水，长脚蚊子一到黄昏就嗡嗡地叫着，翠翠便把蒿艾束成的烟包点燃，向屋中角隅各处晃着驱逐蚊子。	Hard 48 50 角隅
原来有一丛野蔷薇，被铃兰花簇拥着，开出了第一朵粉红色的花。	Normal 11 13 兰花
谁要是怀疑亚里士多德，人们就会责备他：“你是什么意思？	Normal 1 3 要是
高尔基很惊服巴尔扎克小说里写对话的巧妙，以为并不描写人物的模样，却能使读者看了对话，便好像目睹了说话的那些人。	Normal 6 10 巴尔扎克
我若能裁你以为带，我将赠给那轻盈的舞女，她必能临风飘举了。	Hard 2 4 能裁
人文精神还有一层含义，就是重视人的节操和修养，注重之所以成为人的那些道德素质，进而追求人格的完美。	Normal 46 48 完美
吃饭时，凤姐与鸳鸯商议要拿刘姥姥取个笑儿。	Hard 18 20 笑儿
以后我们又做过韭菜合子，又做过合叶饼，我一提议鲁迅先生必然赞成，而我做得又不好，可是鲁迅先生还是在桌上举着筷子问许先生：“我再吃几个吗？”	Normal 53 55 筷子
这个客官道我酒里有甚么蒙汗药。	Normal 0 2 这个
靠近金门大桥则有一处观海鸟的胜地，太平洋海湾中有三个小岩石孤岛，栖息着上万只大嘴鹈鹕、鱼鹰、海鸥。	Hard 40 42 鹈鹕
现在，湖底的树干，古老的独木舟，黑魆魆的四周的林木，都没有了，村民本来是连这个湖在什么地方都不知道的，如今却想到用一根管子来把这些湖水引到村中去洗碗洗碟子了。	Hard 16 19 黑魆魆
邢夫人苦留吃过晚饭去，黛玉笑回道：“舅母爱惜赐饭，原不应辞，只是还要过去拜见二舅舅，恐领了赐去不恭，异日再领，未为不可。	Hard 55 59 未为不可
茶罢，孔明曰：“昨观书意，足见将军忧民忧国之心；但恨亮年幼才疏，有误下问。”	Hard 10 12 书意
第二天小光和小胖请了假,连学校的自然课老师也眼着考察队员一起参加寻找朱鹮的工作。	Hard 34 36 朱鹮
于是，伯父家盖房，想以它垒山墙，但苦于它极不规则，没棱角儿，也没平面儿；用錾破开吧，又懒得花那么大气力，因为河滩并不甚远，随便去掮一块回来，哪一块也比它强。	Hard 64 65 掮
站在正宫前极目远眺，玉带似的人工河上波光粼粼，帆影点点，两侧大树参天，郁郁葱葱，绿阴中女神雕塑亭亭而立。	Normal 3 5 宫前
我的保姆，长妈妈即阿长，辞了这人世，大概也有了三十年了罢。	Normal 15 17 人世
兀自不快下拜，等几时！	Hard 0 6 兀自不快下拜
大索城中；无，则之郭，之村，之山僻，之邻府州县。	Hard 9 10 郭
又枕帕头巾边沿用茉莉花苞作装饰的，比用小三角锯齿纹（通称狗牙齿）时代早些，狗牙齿边盛行于晚清，茉莉花流行于同光时，至于四合如意规矩格子花，则是二百年前式样。	Hard 59 63 四合如意
往常，开始上课的时候，教室里总是一片乱哄哄，街上都听得见，课桌开开关关，大家一起高声诵读，你要专心，就得把耳朵括捂起来，老师用大戒尺不停地拍着桌子喊道：	Normal 0 2 往常
当我第一次学写“河”字的时候，我想到的是浉河。	Hard 20 22 浉河
每当太阳出来的时候，他们就到田地里耕种；每当月亮出来的时候，他们就在月光下织布。	Normal 14 16 田地
天越冷越好，浆得野鸡连眼睛都睁不开。	Hard 6 7 浆
江理以“从者七人，二僧与俱”，组成一支浩浩荡荡的登山队，“一仆前持斧斤，剪伐丛莽，一仆鸣金继之，二三人肩糗执剑戟以随。”	Hard 36 40 剪伐丛莽
真要勉用文字来着色，也不过像谢灵运的一些名句“云日相晕映，空水共澄鲜”或是“出谷日尚早，入舟阳已微。	Hard 23 28 云日相晕映
沃克医生肃然起敬：“啊，川东支队的将令，久仰久仰，认识你很荣幸。”	Normal 2 4 医生
荷塘四面，长着许多树，蓊蓊郁郁的。	Hard 11 15 蓊蓊郁郁
布衾多年冷似铁，	Hard 0 2 布衾
一片片低矮的破房子仿佛是一片片疥疮。	Hard 15 17 疥疮
坐在下面，仿佛置身在一个圆形的乐池里。	Normal 12 14 圆形
春之色为冷的绿，如碧波，如嫩竹，贮满希望之情；秋之色为热的赤，如夕阳，如红叶，标志着事物的终极。	Normal 36 38 红叶
那叫人柔肠寸断的杏花春雨啊，竟把炎黄子民们威武剽悍的魂魄和膂力一并溶化！	Hard 29 31 膂力
燕雀、鸢和歌声婉转的鸫鸟,用清脆、纯净的声音唱着。	Hard 3 4 鸢
河蚌急忙把壳儿合上，牢牢地夹住鹬的嘴不放。	Hard 15 16 鹬
他们威胁说，否则，他们就将给他一顿教训，叫他永不会忘记。	Normal 22 24 永不
今诸君苟不于此时植其基，勤其学，则将来万一因生计所迫，出而仕事，但任讲席，则必贻误学生；置身政界，则必贻误国家。	Hard 22 26 生计所迫
州平曰：“山野之夫，不足与论天下事，适承明问，故妄言之。”	Hard 18 22 适承明问
假如有一天，来了一个游手好闲的家伙，他把布告牌上那个旧数字奚落一番，说这是骗人的玩意，那么，他这番话在这种意义上就是人们的冷漠和天生的恶意所能虚构的最愚蠢不过的谎言，因为饥饿艺术家诚恳地劳动，不是他诳骗别人，倒是世人骗取了他的工钱。	Normal 113 115 工钱
但随后也就自笑，觉得偶尔的事，本没有什么深意义，而我偏要细细推敲，正无怪教育家要说是生着神经病；而况明明说过“说不清”，已经推翻了答话的全局，即使发生什么事，于我也毫无关系了。	Normal 44 47 神经病
铁路管理局通知说，已经没有枕木了。	Hard 13 15 枕木
每当我们读文天祥的《正气歌》“天地有正气，杂然赋流形，下则为河岳，上则为日星……”	Hard 21 26 杂然赋流形
我想在坐的诸君之中一定有些这样的经验，有的不喜欢算学，有的不喜欢博物，然而不得不学，否则，不能毕业，不能升学，和将来的生计便有妨碍了。	Normal 56 58 将来
“绿”字描绘出了江南春风的气韵，引出下句“明月何时照我还”。	Hard 27 28 还
她们在家乡的道路上行军，眼望着天边的北斗。	Normal 15 17 天边
中华鲟也是一种古生物，它有一亿多年的历史。	Hard 0 3 中华鲟
就要收庄稼了，收庄稼前，要把道路修一修，补一补，这是村里的风俗。	Hard 29 31 风俗
老师从一大堆泥鸭子、布娃娃、木制品中，拿出一个很不像样的小板凳，生气地问：“你们谁见过这么糟糕的小板凳？”	Normal 45 47 糟糕
这种发明还有一大好处：它可以作为一切文明国家都可以通晓的共同语言，因为各国的货物、器具大体相同或者类似，所以它们的用途就很容易了解。	Normal 57 59 用途
不想森林却从此遭了殃。	Normal 5 7 从此
放眼望去，尽是姑娘们的七彩裙、花头帕、绣花坎肩和小伙子们的白披毡、蓝披毡、花腰带，好像一个硕大无朋的五彩花环罩在青苍的碧野上。	Normal 19 21 绣花
我获得的土地的价格很低，一公顷还不到两个卢布。	Hard 20 22 卢布
然而，在另一篇题为《从生物学的角度向米老鼠致敬》中，古尔德却又对“粗略的大小和外在的形状”，也就是这方面的数字，发生了极大的兴趣，而且用它们来捍卫自己的幼态持续学说。	Hard 76 78 幼态
少停，外边先传进一阵敲门的声音，接着走进一男一女，男的一望而知是一个警察，女的一手提了一个小包袱，从她可怜神情，也不难猜出，她就是闯了祸的李嫂。	Hard 0 2 少停
台上，顶碗少年呆呆地站着，脸上全是汗珠，他有些不知所措了。	Normal 17 19 汗珠
一条修长的石路，右面尽是田亩，左面是一条清澈的小河。	Normal 15 17 左面
他家的二小姐着实爽快，会待人的，倒不拿大，如今现是荣国府贾二老爷的夫人，听见他们说，如今上了年纪，越发怜贫恤老的了，又爱斋僧布施。	Hard 18 20 拿大
2008名乐手击缶，声又变成了光——组成让人心跳的数字，和着读秒时刻:“5——4——3——2——1！”	Hard 7 9 击缶
时云长在侧曰：“某闻管仲、乐毅乃春秋、战国名人，功盖寰宇；孔明自比此二人，毋乃太过？”	Hard 8 12 某闻管仲
面对肆虐的洪水，更显出人民子弟兵铮铮铁汉的本色。	Normal 9 11 显出
冈重岭复，乔木苍苍。	Hard 5 9 乔木苍苍
有一处需经隧道，穿山而过；俯瞰脚下峡谷，只见一股清流急湍其间，环顾四周，岩壁巉峻，丘岗葱绿，美不胜收。	Hard 36 40 岩壁巉峻
我小时候，一年四季不论刮风下雨，胡同里从早到晚叫卖声没个停	Normal 16 18 胡同
缅伯高晓行夜宿，餐风饮露，来到陕西沔阳，离京城已经不远，见一片湖水在前，十分清澈。	Hard 17 19 沔阳
它懂得阳光虽然嫌弃它，时间却是公正的，为此它宁可付出几万年的代价。	Normal 22 24 宁可
虽然远处大片大片的花与蒙蒙细雨融在一起，低头却能清晰地看到，在冷雨中，每一朵小花都傲然挺立，明亮夺目，神气十足。	Normal 20 22 低头
今诸君苟不于此时植其基，勤其学，则将来万一因生计所迫，出而仕事，但任讲席，则必贻误学生；置身政界，则必贻误国家。	Hard 3 6 苟不于
在这里，谁都不叫喊吆喝，牛的脖子上的铃铛也没有响声，挤奶的人更是默默无言。	Normal 26 28 挤奶
六岁的小女孩柔弱的身体成了黑脸大汉手中一块生面团，翻过来、椆过去、立起来、横过去，抻、拉、压、拽，为所欲为，奶奶看不过我被整得满脸的泪水和汗水，每次都目不忍视地躲到里屋。	Hard 41 42 抻
他是那么潇洒地将花束抛向了乐手们，台下响起了激动人心的掌声，于是，郎朗又一次深深弯下腰，行了一个绅士派头的大礼，然后，沉静地端坐在钢琴前——钢琴那乌亮的板壁在灯光下反射的光泽，在我看来都具有了强烈的离情色彩。	Hard 99 101 离情
“你原来是条整鱼。	Hard 6 8 整鱼
头发约莫寸长，显然好久没剪了，却一根一根精神抖擞地直竖着。	Normal 0 2 头发
它们对这道菜吃得津津有味，以至于两三个星期间，这个笼子里到处都是蝉肉被吃光后剩下的头骨和胸骨，扯下来的羽翼和断肢残腿。	Normal 13 16 以至于
平生没走过这么“野”的路！	Normal 3 5 走过
果一变变作个鱼鹰儿，飘荡在下溜头波面上。	Hard 13 16 下溜头
您用手拨开濡湿的树枝，夜里蕴蓄着的一股暖气立刻向您袭来；空气中到处充满着苦艾的新鲜苦味、荞麦和三叶草的甘香；远处有一片茂密的橡树林，在阳光底下发出闪闪的红光；天气还凉爽，但是已经觉得炎热逼近了。	Normal 44 46 荞麦
而最令人遗憾的是，最后两位同学没上几天学，就由于疾病或其他原因而相继退学了。	Normal 34 36 退学
中国使者抱拳，作揖还礼：“有劳将军远迎。	Hard 7 11 作揖还礼
我看见蜘蛛把它的腿像球样旋动，静静地躺上几小时，一直小心翼翼地注视着外界的动静，当一只苍蝇碰巧爬得够近时，它就忽然冲出洞穴，攫住它的俘获物。	Hard 62 64 攫住
我说它像勒勒车的轮子，只是一个顺手攫来的想法，它当然较这轮子要大得多。	Hard 17 19 攫来
现在，在这海拔8500米以上的冰雪世界里，这四位优秀的中国登山队员在一根红色的结组绳的牵引下，齐心协力，朝着云雾茫茫的珠穆朗玛峰巅勇敢地迈进。	Normal 15 17 冰雪
武松走了一程，酒力发作，热起来了，一只手提着哨棒，一只手把胸膛敞开，踉踉跄跄，奔过乱树林来。	Hard 22 24 哨棒
去年的粜价是七块半，今年的米价又卖到十三块，不，你先生说的，十五块也卖过；我们想，今年总该比七块半多一点吧。	Hard 3 5 粜价
例如《诗经·鲁颂》的《駉》这一首诗里提到马的名称就有16种：“驈”(身子黑而胯下白的)，“皇”(黄白相间的)，“骊”(纯黑色的)，“黄”(黄而杂红的)，“骓”(青白杂的)，“駓”(黄白杂的)，“騂”(红黄色的)，“骐”(青黑成纹像棋道的)，“驒”(青黑色而有斑像鱼鳞的)，“骆”(白马黑鬃)，“駵”(红马黑鬃)，“雒”(黑马白鬃)，“駰”(灰色有杂毛的)，“騢”(红白杂毛的)，“驔”(小腿长白毛的)，“鱼”(两眼旁边毛色白的)。	Normal 22 24 名称
“公等”是指徐霞客一行冒雪攀山的游客，仰见下山的群僧，乃有“冉冉僧一群从天而下”的奇句，虽武侠片也	Hard 30 32 冉冉
假如一个人在家里，不管是不是有人在看书或者在做功课，即便做功课的是他年龄幼小的孩子，他都不管不顾地打开收音机或者电视，并且把音量放得很大，或者随心所欲地高声说话——那么，可以断定这个人缺乏教养，而且他永远也不会把自己的子女培养成有涵养的人。	Normal 29 31 功课
坦诚地讲，这一诱惑是最大的，而且整个设计也贯穿了生态恢复和废旧再利用的思想，其中的许多方法也借鉴到本设计中来了。	Normal 18 20 设计
每年的5月至10月是这条河的高水位期，连续几天下了急雨，宽宽的河面上泛着油浪，水流湍急。	Hard 41 43 湍急
散工回来的时候，老板和两个打杂的站在门口，横肉脸上在发火了，一把扭住她的头发，踢，打，掷，和爆发一般的听不清的嚷骂：	Normal 36 38 头发
树也砍光了，那月桂，那枫树，柳树和擎天的巨椰，雨来的时候不再有从叶嘈嘈切切，闪动湿湿的绿光迎接。	Normal 38 40 闪动
便是现在心目中的离奇和芜杂，我也还不能使他即刻幻化，转成离奇和芜杂的文章。	Normal 34 36 文章
曾子还说哩：“任重而道远”，“死而后已，不亦远乎！”	Hard 7 12 任重而道远
后来，黑子不再信赖它的训导员，甚至不再信赖所有的人。	Normal 5 7 不再
例如《诗经·鲁颂》的《駉》这一首诗里提到马的名称就有16种：“驈”(身子黑而胯下白的)，“皇”(黄白相间的)，“骊”(纯黑色的)，“黄”(黄而杂红的)，“骓”(青白杂的)，“駓”(黄白杂的)，“騂”(红黄色的)，“骐”(青黑成纹像棋道的)，“驒”(青黑色而有斑像鱼鳞的)，“骆”(白马黑鬃)，“駵”(红马黑鬃)，“雒”(黑马白鬃)，“駰”(灰色有杂毛的)，“騢”(红白杂毛的)，“驔”(小腿长白毛的)，“鱼”(两眼旁边毛色白的)。	Hard 56 57 骊
云海汩汩地围着山头，大有海中孤岛的虚幻感。	Hard 2 4 汩汩
这位宋朝的隐士林和靖，妻梅子鹤，终老是乡，范仲淹曾赞美他“片心高与月徘徊，岂为千钟下钓台。	Hard 29 36 片心高与月徘徊
于是六国之士，有宁越、徐尚、苏秦、杜赫之属为之谋，齐明、周最、陈轸、召滑、楼缓、翟景、苏厉、乐毅之徒通其意，吴起、孙膑、带佗、倪良、王廖、田忌、廉颇、赵奢之伦制其兵。	Hard 31 33 陈轸
比如说苏东坡的“惠山烹小龙团”诗里三四两句“独携天上小团月，来试人间第二泉”，“天上小团月”是由“小龙团”茶联想起来的，如果你不知道这个关联，原文就简直不通。	Hard 34 37 第二泉
金龟子的折扇，跟天牛长长的须角、锹甲的铁锹般的上颚一样，都是发育成熟可以求偶的标志，只是外形各不相同而已。	Normal 50 52 而已
我把秋天比作一个穿着金色衣裙的仙女，她那轻飘的衣袖拂去了太阳的焦热，将明亮和清爽撒给大地；她用宽大的衣衫挡着风寒，却捧起沉甸甸的果实奉献人间。	Normal 23 25 衣袖
溪西一带山，俱似鹦绿鸦背青，上有腥红云五千尺，开一大洞，逗出缥天，映水如绣铺赤玛瑙。	Hard 28 32 逗出缥天
她站在枕木上，回头望着笔直的铁轨，铁轨在月亮的照耀下泛着清淡的光，它冷静地记载着香雪的路程。	Normal 14 16 铁轨
他居然把亚里土多德的神圣的卷帙从书架上搬走，而代之以绳索、锡块、杠杆，圆形的、多角形的、平面的这样那样滑稽的玩意儿。	Hard 13 15 卷帙
马俑与真马一般大小，一匹匹形体健壮，肌肉丰满。	Normal 7 9 大小
罗汉就塑得比孩子们高得多，虽然不过是上小下大的一堆，终于分不清是壶卢还是罗汉；然而很洁白，很明艳，以自身的滋润相粘结，整个地闪闪地生光。	Hard 32 34 壶卢
七尺阔、十二尺深的工房楼下，横七竖八地躺满了十六七个“猪猡”。	Normal 11 13 楼下
可是每逢我的病人开始盘算有多少辆马车送他出殡的时候，我就得把医药的治疗力量减去百分之五十。	Hard 20 22 出殡
队伍出发了，行军灶打头，后边是孩子和中尉并排走着。	Normal 20 22 并排
哪家出了美女，哪家的瓦板房四周，晚间便口弦声不断，清晨背水路上的脚印最多。	Hard 19 22 口弦声
可是，他们不知道怎么分这块奶酪，小哥儿俩开始拌起嘴来。	Normal 0 2 可是
田间与灌木篱下，横陈着田凫、椋鸟、画眉等数不清的腐鸟的血衣，鸟儿的肉已被隐秘的老饕吃净了。	Hard 14 16 椋鸟
刘部进入大别山，陈赓部进入伏牛山，已形成椅角之势，从此中原无宁日矣……	Hard 8 11 陈赓部
忽见堂屋中柱子上挂着一个匣子，底下又坠着一个秤砣似的，却不住的乱晃。	Normal 15 17 底下
1910年他加入同盟会，筹款资助孙中山先生领导的辛亥革命；抗日战争爆发，他担任南洋华侨总会主席，捐资抗日，不顾危险，亲身回国考察战事、慰劳将士。	Hard 24 28 辛亥革命
农舍里点着松明，发出红色的火光，大门里面传出瞌睡朦胧的说话声。	Normal 0 2 农舍
独夜卧人静，风涛汹汹，直逼枕簟，鱼龙舞啸，其形声时入梦寐间，意洒然快也。	Hard 13 15 枕簟
那还是七八年前，在斯特兰剧院，他刚被解聘，问我借了半克朗钱。	Normal 1 3 还是
奥斯里克殿下，王上已经用六匹巴巴里的骏马跟他打赌；在他的一方面，照我所知道的，押的是六柄法国的宝剑和好刀，连同一切鞘带钩子之类的附件，其中有三柄的挂机尤其珍奇可爱，跟剑柄配得非常合式，式样非常精致，花纹非常富丽。	Hard 57 59 鞘带
斯帕拉捷的实验，揭开了蝙蝠飞行的秘密，促使很多人进一步思考：蝙蝠的耳朵又怎么能“穿透”黑夜，“听”到没有声音的物体呢？	Normal 30 32 蝙蝠
所有的人都鼓掌欢呼起来。	Normal 0 2 所有
山顶的鱼鳞松时时顾盼着它。	Normal 6 8 时时
辞岁之后，从长辈得到压岁钱，红纸包着，放在枕边，只要过一宵，便可以随意使用。	Normal 10 13 压岁钱
斯科特接受了这项任务，他要忠实地去履行这一最冷酷无情的职责：在世界面前为另一个人完成的业绩作证，而这一事业正是他自己所热烈追求的。	Normal 33 35 面前
事实上，在火山活动地区至今没有发现过斯石英。	Hard 18 21 斯石英
悼公立即派使者去召解狐，没想到解狐大病在身，卧床不起，不久就去世了。	Normal 30 32 去世
腮上没有多余的肉，脖子可是几乎与头一边儿粗；脸上永远红扑扑的，特别亮的是颧骨与右耳之间一块不小的疤——小时候在树下睡觉，被驴啃了一口。	Hard 36 38 颧骨
崔杼等他写好,拿过竹简一看,上面写着:“夏五月,崔杼谋杀国君光。”	Normal 14 16 上面
青的草，绿的芽，各色鲜艳的花，都像赶集似的聚拢来，形成了灿烂无比的春天。	Hard 17 19 赶集
最年轻的姑娘侬香得知了杀死火魔的秘密。	Hard 13 15 火魔
罗伯特为攒钱买战斗机这事非常苦恼。	Normal 0 3 罗伯特
李白时代的诗人，既挚恋着四川的风土文物，又向往着下江的开阔文明，长江于是就成了他们生命的便道，不必下太大的决心就解缆问桨。	Hard 56 60 解缆问桨
其实，臣子对君王的进谏，实在是一种刀斧手阴影下的血腥冒险。	Normal 3 5 臣子
是在我们结婚的大喜之日，她的“拜钱”。	Hard 15 17 拜钱
白白的米换不到白白的现洋钱，好像又被他们打了个折扣，怪不舒服。	Normal 28 30 舒服
就把我们的油水一古脑儿吞了去！	Normal 11 12 吞
徽曰：“孔明与博陵崔州平、颍川石广元、汝南孟公威与徐元直四人为密友。	Hard 0 1 徽
当时三人坐下，李逵便道：“酒把大碗来筛，不奈烦小盏价吃。”	Hard 23 27 小盏价吃
同一文中也有日出之景。	Normal 0 2 同一
让我们穿越时空隧道，访问中生代的地球，看看这一演化过程吧！	Normal 16 18 地球
它在地上打着滚，捧着肚子，咬着胡须和尾巴，竭力忍着不笑出来。	Normal 18 20 尾巴
形态不同，性质各异，但有一点是相同的，最小单位都是原子。	Normal 19 21 最小
民间所传二十八宿，即刘秀的二十八个主要干部，多是出生于南阳一带。	Hard 4 8 二十八宿
对于这位敬爱的首长，杨光不但知道，还曾亲眼看见过。	Hard 7 9 首长
他说：“我希望政府向携带艾滋病病毒的孕妇提供艾滋病药物，使她们不再把病毒传染给自己的孩子。”	Hard 12 15 艾滋病
他见我挨他坐下，立即张惶起来，好像他身边埋下了一颗定时炸弹，局促不安，掉过脸去不好，不掉过去又不行，想站起来又不好意思。	Normal 20 22 埋下
它“是一首精巧的诗”，“一首韵在骨子里的散文诗”，言有尽而意无穷。	Hard 25 32 言有尽而意无穷
第二、三、四段分别写三位名人的事例，其中纪昌、王義之的事例写得过于简略，太笼统，看不出射手、书法家苦练基本功的具体特点，这就削弱了这篇议论文的说服力。	Normal 43 45 射手
如雨打沙滩的遗迹，水波使水底泥沙掀起的波痕，古代动物走过的脚印和天旱时候泥土龟裂的形象……	Normal 9 11 水波
新年才过，她从河边掏米回来时，忽而失了色，说刚才远远地看见几个男人在对岸徘徊，很像夫家的堂伯，恐怕是正在寻她而来的。	Hard 44 46 堂伯
我的思念越过蜿蜒曲折的小溪，升到高高的冈峦上，在塔亭般的瞭望楼里，我要同你一起倚窗外望……	Normal 37 39 一起
故尧舜一日万机，文王日晷不暇食，仲尼终夜不寝，颜子欲罢不能，自此以下莫敢淫心舍力，故曰自强不息矣。	Hard 10 15 日晷不暇食
这一研究对揭示基因如何控制花的形状提供了可参考的信息，同时还有可能被参照用来培育形状独特的珍奇花卉。	Normal 15 17 形状
被子植物的花有了花被，更分化为萼和花冠。	Hard 15 16 萼
金镀在全部铜丝上，方法用电镀。	Hard 12 14 电镀
然后每天站在虱子旁边，聚精会神地盯着它。	Hard 6 8 虱子
有一天，小刺猬来了，伸出小撅嘴，眨着小眼睛，高高兴兴地吃起来了。	Hard 13 15 撅嘴
生命的确是像一朵火焰，来去无踪，无时不是动着，忽然扬焰高飞，忽然销沉将熄，最后烟消火灭，留下一点残灰，这一朵火焰就再也燃不起来了。	Normal 8 10 火焰
《红楼梦》第四十九回里就有这样一段：“黛玉换上掐金挖云红香羊皮小靴，罩了一件大红羽绉面白狐皮的鹤氅，系一条青金闪绿双环四合如意绦，上罩了雪帽。”	Hard 47 49 鹤氅
她微笑的时候，那黑得像黑樱桃的眼珠儿睁得圆圆的，闪出一种难以形容的愉快光芒，在笑容里，快活地露出坚固的雪白的牙齿，虽然黑黑的，两颊有许多皱纹，但整个面孔仍然显得年轻，明朗。	Normal 15 18 眼珠儿
这里包含的诗人的感情，是对寒冷环境的反抗，也是对不屈的、斗争的品格的歌颂，有荷戟独彷徨的孤寂之感，也有永不停息战斗的低强精神。	Hard 38 43 荷戟独彷徨
可是墙壁上有砖砌的各式镂空图案，廊子大多是两边无所依傍的，实际是隔而不隔，界而未界，因而更增加了景致的深度。	Normal 2 4 墙壁
范围是早自经史，晚到小说，旁及佛典，凡古人用做比喻的话，少自片语，多至成篇，无不采择，真可谓洋洋大观。	Normal 23 25 比喻
他唯一的女儿三番五次地从城里回来，接他去享清福，他不走。	Normal 4 6 女儿
如果我只图自己省事而敷衍他，不帮他解决‘燃眉之急’，可能会永远失去这个顾客。	Normal 35 37 顾客
大索城中；无，则之郭，之村，之山僻，之邻府州县。	Hard 1 2 索
虽然我毫无疑义地判定儿子患的只是普通感冒，如果寻找适宜锻炼看病的病种，这是最好的选择，但我还是深深地谴责自己。	Hard 32 34 病种
那树有一点佝偻，露出老态，但是坚固稳定，树顶像刚炸开的焰火一样繁密。	Normal 15 17 坚固
似乎可以肯定地说，斯石英也应该出现在压力极高的地壳深处。	Hard 23 25 地壳
在克隆鲫鱼出现之前，英国牛津大学的科学家已经在1960年和1962年，先后用非洲一种有爪的蟾蜍(非洲爪蟾)进行过克隆试验。	Hard 45 47 蟾蜍
他听到我的叫声，身子哆嗦了一下，跳下台阶，爬上踏脚板，悄悄地说：“叔叔，你怎么知道我叫凡尼亚呢？”	Normal 33 35 叔叔
说中国人失掉了自信力，用以指一部分人则可，倘若加于全体，那简直是诬蔑。	Normal 11 13 用以
柳枝儿抱回家来，奶奶便把柳叶儿捋进盒里、筐里，然后烧一锅开水煮，煮好之后，又捞进凉水里泡。	Hard 15 16 捋
在那春之宫殿，同粉蝶追欢取乐的桃花，自下而上，攀附他物的紫罗兰，还有那以富贵夸耀人世的牡丹，早已沉没在尘俗的荒漠里。	Normal 40 42 人世
知名人士、年轻人、明亮的汽灯、人们身上的香水味、小提琴和单簧管的校音声……	Normal 12 14 汽灯
夸父又向北方跑去，想去喝大泽里的水。	Normal 4 6 北方
冰雪融化，草木萌发，各种花次第开放。	Hard 13 15 次第
羿又伸手拔箭，准备射下最后一个太阳。	Hard 0 1 羿
在安造垸，他们救出了被洪水围困了三天三夜的幼儿园老师周运兰；在簰州湾，他们给攀上树梢等待了近九个小时的小江珊以生的希望……	Hard 1 4 安造垸
不久，英国政府采纳了罗兰希尔的建议，批准了世界上第一种邮资凭证——邮票，规定信件不超过半盎司（相当于14克），收费1便士。	Hard 58 60 便士
以后我常做这样的游戏，有时和太阳赛跑，有时和西北风比赛，有时一个暑假的作业，我十天就做完了。	Normal 22 25 西北风
她一入水，大概就觉得不对头，连忙矫捷地回到岸上，把月亮的倒影打得支离破碎，好久才恢复了原形。	Normal 43 45 原形
舒活舒活筋骨，抖擞抖擞精神，各做各的一份事去，“一年之计在于春”；刚起头儿，有的是工夫，有的是希望。	Hard 24 31 一年之计在于春
公爵大家让开些，让他站在我的面前。	Normal 4 6 让开
可是祥林嫂真出格，听说那时实在闹得利害，大家还都说大约因为在念书人家做过事，所以与众不同呢。	Normal 30 32 念书
黄河的波浪激荡着我关于敌后几年生活的回忆，激荡着我对于那女孩子的纪念。	Normal 11 13 敌后
贾芸便呆呆的坐到晌午，打听凤姐回来。	Hard 8 10 晌午
太奇妙了，我们即使充分发挥丰富的想象力来拟定进攻计划，也无法找到比这更好的办法，而古代角斗场上的角斗士在与对手内搏时，也不一定能采取比这更巧妙的经过精心计算的手段的。	Normal 1 3 奇妙
阴房修在山坡上，样子很像碉堡，四周留着许多小孔，里面钉着许多木架子。	Hard 0 2 阴房
有时候，他引诱你到语言文字的穷边涯际，下面是深秘的静默：“此中有真意，欲辨已忘言。”	Hard 29 34 此中有真意
除了供查诗韵外，它还把各种物象、各种情景、各种心绪分门别类，纂集历代相关诗句，成了一部颇为齐全的诗歌词典。	Hard 30 32 纂集
它把西瓜的瓤涂红了。	Hard 5 6 瓤
第一次是雨季，临出发时有人告诫：“这个时节看壶口最危险，千万不要到河滩里去，赶巧上游下雨，一个洪峰下来，根本来不及上岸。”	Normal 57 59 上岸
赶过前面冈子去，却再理会。	Normal 10 12 理会
它们在劳动中经常是披着鞍辔的；人家从来不解除它们的羁绊，纵然是在休息的时候；如果人家偶尔让它们在牧场上自由地行走，它们也总是带着奴役的标志，并且还时常带着劳动与痛苦所给予的残酷痕迹：嘴巴被衔铁勒得变了形，腹侧留下一道道的疮痍或被马刺刮出一条条的伤疤，蹄子也都被铁钉洞穿了。	Hard 11 13 鞍辔
过了这么多年，藤萝又开花了，而且开得这样盛，这样密，紫色的瀑布遮住了粗壮的盘虬卧龙般的枝干，不断地流着、流着，流向人的心底。	Hard 37 41 盘虬卧龙
天资聪颖的邓稼先牢牢地记住了父亲的话。	Normal 11 13 记住
但“人”不仅是在系统发育谱上属于脊椎动物门”、哺乳动物纲、灵长类、人科、人属的人，而且是心理、社会的人(人格)。	Normal 23 27 哺乳动物
袁世凯的亲信陈宧对章太炎的评价更高，因为章太炎最初见到陈宧时，便说过陈宧这人是第一等人物，然而日后灭亡民国者，必此人无疑。	Normal 49 51 灭亡
终于还是将那层干菜帮子全部撕光，露出了鲜嫩的、洁白的菜帮。	Hard 9 11 帮子
于是分头四出，寻黑矮汉，寻梢长大汉，寻头陀，寻胖大和尚，寻茁壮妇人，寻姣长妇人，寻青面，寻歪头，寻赤须，寻美髯，寻黑大汉，寻赤脸长须。	Hard 12 17 寻梢长大汉
旧籍记载荔枝，说到有的品种皮粗厚，刺尖，唐代徐夤诗云“龙绢壳绽红纹粟”，就已观察到这种构造。	Hard 27 34 龙绢壳绽红纹粟
──如果美是专指“婆娑”或“横斜逸出”之类而言，那么白杨树算不得树中的好女子；但是它却是伟岸，正直，朴质，严肃，也不缺乏温和，更不用提它的坚强不屈与挺拔，它是树中的伟丈夫！	Hard 9 11 婆娑
屋里铺位都满了，我就把这位重伤员安排在屋檐下的那块门板上。	Normal 0 2 屋里
公爵，我已经差人去请培拉里奥，一位有学问的博士，来替我们审判这件案子；要是他今天不来，我可以有权宣布延期判决。	Normal 18 20 学问
白开水清洁、解渴，还含有其他饮料不具备的生物活性，是质优价廉的饮料。	Hard 22 24 活性
接着，我摇动小包，打开折叠，往身上挤几滴肥皂水。	Normal 9 11 打开
江理以“从者七人，二僧与俱”，组成一支浩浩荡荡的登山队，“一仆前持斧斤，剪伐丛莽，一仆鸣金继之，二三人肩糗执剑戟以随。”	Hard 29 35 一仆前持斧斤
他轻轻地把桨举起来，尽量轻轻，因为他的手痛得不听使唤了。	Normal 12 14 轻轻
但她大概也即觉到了，说道：“像你似的小孩子，长毛也要掳的，掳去做小长毛。	Hard 26 27 掳
兀自不快下拜，等几时！	Hard 7 10 等几时
多谢您对我的想法予以重视。	Normal 6 8 想法
有一双挥洒自如的手固然是至关重要的，作为一名优秀的二传手，还必须具有宽大的胸怀。	Normal 22 24 优秀
晚饭摆出来了，四叔俨然的陪着。	Hard 9 11 俨然
血和惨叫使整个工房的人都怔住了，大家都在发抖，这好像真是一个榜样。	Hard 12 13 怔
中国婚姻方法的缺陷，才子佳人小说作家早就感到了，他于是使一个才子在壁上题诗，一个佳人便来和，由倾慕——现在就得称恋爱——而至于有“终身之约”。	Normal 61 63 至于
这里有特别美、特别大、色彩特别绚丽的老弗里茨像，他目光炯炯，身着天蓝色的军服，胸前的大星章金光闪闪。	Normal 45 49 金光闪闪
身临其境，我和爸爸也不由自主地手舞足蹈起来。	Normal 19 21 起来
我将看见所有的人们在我面前低头，鞠躬，匍匐，连同我的尊长，我的师友，和从前曾在我面前昂头阔步、耀武扬威的人们。	Hard 26 28 尊长
那朵红莲，被那繁密的雨点，打得左右欹斜。	Hard 17 19 欹斜
每天舞蹈般婆娑变化的只是远远近近的游云，颜色也变幻莫定。	Hard 5 7 婆娑
什么都有：稻鸡，角鸡，鹁鸪，蓝背……	Normal 2 3 都
因为，每当他们来到他的面前时，便立即在他周围吵嚷得震天价响，并且不断形成新的派别互相谩骂，其中一派想要悠闲自在地把他观赏一番，他们并不是出于对他有什么理解，而是出于心血来潮和对后面催他们快走的观众的赌气，这些人不久就变得使饥饿艺术家更加痛苦；而另一派呢，他们赶来的目的不过是想看看兽畜而已。	Normal 99 101 赌气
你只会感到更高邈、深远，并让凄冷的雨滴，去纯净你的灵魂，而且一定会遥望到一场秋雨后将出现的一个更净美、开阔的大地。	Hard 6 8 高邈
它没有朋友，只好继续流浪。	Normal 6 8 只好
蓝天瘦的时候，云就多些，是白底蓝花的的青花瓷器，是明代官窑的极品；蓝天胖的时候，云就少些，是蓝底白花布，那是黔贵山区民间的手工蜡染粗布。	Normal 30 32 极品
父亲愉快地告诉我，他去世后要捐赠所有完好的器官，尤其是眼睛角膜。	Hard 29 31 角膜
袁世凯称帝，最终失败，和陈宧关键时刻的倒戈有绝对关系。	Hard 12 14 陈宧
可惜它们并不真正存在，当彩虹悄然隐去，海市无声消失的时候，人们仍然只能依靠自己的双脚走出戈壁，去寻找活水和黑土，寻找蔚蓝色的大海和坚实的船帆。	Hard 44 46 戈壁
腊月二十三过小年，香烛纸马送灶王爷上天。	Hard 14 17 灶王爷
例如《诗经·鲁颂》的《駉》这一首诗里提到马的名称就有16种：“驈”(身子黑而胯下白的)，“皇”(黄白相间的)，“骊”(纯黑色的)，“黄”(黄而杂红的)，“骓”(青白杂的)，“駓”(黄白杂的)，“騂”(红黄色的)，“骐”(青黑成纹像棋道的)，“驒”(青黑色而有斑像鱼鳞的)，“骆”(白马黑鬃)，“駵”(红马黑鬃)，“雒”(黑马白鬃)，“駰”(灰色有杂毛的)，“騢”(红白杂毛的)，“驔”(小腿长白毛的)，“鱼”(两眼旁边毛色白的)。	Hard 167 168 駰
鞭炮放过一阵后，用长凳脚绑着的大筒烟火，在敞坪一端燃起了引线，先是咝咝的流泻白光，慢慢的这白光便吼啸起来，作出如雷如虎惊人的声音，白光向上空冲去，高至二十丈，下落时便洒散着满天花雨。	Normal 9 11 长凳
江主席问王辉：“《唐诗三百首》和《古文观止》都读过吗？”	Normal 3 6 问王辉
起先，帕霍姆走得不慌不忙。	Hard 3 6 帕霍姆
只有那些潜藏在水面下的暗礁们非常仇视灯塔。	Normal 16 18 仇视
若果他那文章还值得称引，我们尚可以就“沅有芷兮澧有兰”与“乘舲上沅”这些话，估想他当年或许就坐了这种小船，溯流而上，到过出产香草香花的沅州。	Normal 50 52 小船
他家的二小姐着实爽快，会待人的，倒不拿大，如今现是荣国府贾二老爷的夫人，听见他们说，如今上了年纪，越发怜贫恤老的了，又爱斋僧布施。	Normal 6 8 着实
包扎所的担架不够了，好几个重彩号不能及时送后方医院，耽搁下来。	Hard 13 16 重彩号
这声音穿过茫茫太空，传到北京指挥控制中心，传到游弋在浩瀚大洋上的“远望”3号测量船，传到每一个炎黄子孙的心中。	Hard 23 25 游弋
到了仲夏，呜蝉将在你的浓阴下长啸，等一场台风袭过，那啰哕蝉鸣变成了凄切的哀吟，天气也随之凉爽起来。	Hard 26 30 啰哕蝉鸣
一个冬天的夜里，她从歌剧院回来，冻得全身直打哆嗦，第二天不停地咳嗽，一个星期以后就害肺炎死了。	Normal 10 13 歌剧院
雨一个劲儿在屋顶上劈里啪啦下，隆隆的雷声震动着小房子。	Normal 1 5 一个劲儿
汉语的声调和语音的高低、长短都有关系，而古人把四声分为平仄两类，区别平仄的标准似乎是长短，而不是高低。	Hard 27 29 平仄
我只好解开重扣，爸爸说还要加上14秒时间，这样，我就降为第三名了。	Hard 5 7 重扣
母亲骄傲，腹部的妊娠纹象征孕育和新生；遇害者脖颈上可疑的道道抓痕，身体上深浅不一的刀伤，组成罪孽的恐怖条痕——斑纹无处不在，将两极秘密地衔接，像族徽，凝聚着世袭的生和死，荣与辱。	Hard 46 48 罪孽
这个唤做“智取生辰纲”。	Hard 7 10 生辰纲
我说：“我要嫁那个卖灶糖的老汉！”	Hard 10 12 灶糖
例如《诗经·鲁颂》的《駉》这一首诗里提到马的名称就有16种：“驈”(身子黑而胯下白的)，“皇”(黄白相间的)，“骊”(纯黑色的)，“黄”(黄而杂红的)，“骓”(青白杂的)，“駓”(黄白杂的)，“騂”(红黄色的)，“骐”(青黑成纹像棋道的)，“驒”(青黑色而有斑像鱼鳞的)，“骆”(白马黑鬃)，“駵”(红马黑鬃)，“雒”(黑马白鬃)，“駰”(灰色有杂毛的)，“騢”(红白杂毛的)，“驔”(小腿长白毛的)，“鱼”(两眼旁边毛色白的)。	Hard 121 122 驒
“乡亲”还沽了一点酒，向熟肉店里买了一点肉，回到停泊在万盛米行船埠头的自家的船上，又从般梢头拿出盛着咸菜和豆腐汤之类的碗碟来，便坐在船头开始喝酒。	Hard 5 6 沽
“进士致身卿相为社会心理群趋之鹄的”，这跟科举考试有很大的关系，即汉魏以来中国古代知识人的地位大幅度上升有很大的关系，跟唐代的国力有很大的关系，这是中国文化的复兴之象。	Hard 12 17 群趋之鹄的
而在当今轰轰烈烈的城市建设高潮中，这种记忆是稍纵即逝的，由于其中所掺杂的极端的现象，甚至就连亲身经历过的人们也会怀疑其真实性，更不用说他们的后代了。	Normal 36 38 极端
比较早的有葡萄、苜蓿、茉莉、苹果、菠菜等等，近代的像咖啡、可可、柠檬、雪茄、巧克力、冰淇淋、白兰地、啤酒、卡片、沙发、扑克、哔叽、尼龙、法兰绒、道林纸、芭蕾舞等等，都是极常见的。	Hard 72 75 道林纸
我看见蜘蛛把它的腿像球一样旋动，静静地躺上几小时，一直小心翼翼地注视着外界的动静，当一只苍蝇碰巧爬得够近时，它就忽然冲出洞穴，攫住它的俘获物。	Hard 63 65 攫住
当人们旅行得渴不可耐的时候，忽然看见一个很大的湖，里面蓄着碧蓝的清水，看来并不很远。	Normal 29 31 碧蓝
心下想时，只见一群媳妇丫鬟围拥着一个人从后房门进来。	Hard 11 13 丫鬟
为了避雨，祖孙二人同那只黄狗，走到顺顺吊脚楼上去，挤在一个角隅里。	Hard 19 22 吊脚楼
终于还是将那层干菜帮子全部撕光，露出了鲜嫩的、洁白的菜帮。	Normal 23 25 洁白
真要勉用文字来着色，也不过像谢灵运的一些名句“云日相晕映，空水共澄鲜”或是“出谷日尚早，入舟阳已微。	Hard 38 43 出谷日尚早
这时，几十只幼龟已成了嘲鹰、海鸥、鲣鸟的口中之食。	Hard 17 19 鲣鸟
且听水手之一说楼上妇人的爸爸是七年前在棉花坡被人杀死的，一共杀了十七刀。	Normal 9 11 妇人
老刘头天天在桥上转悠，不停地用扳子拧呀、敲呀，衣服湿透了都不歇会儿。	Normal 15 17 扳子
相传孙中山先生在1912年3月辞去临时大总统的职务以后，曾经到钟山来打猎，看到周围地势开阔，风物优美，气概雄伟，景象万千，就表示了身后要埋葬在这里的愿望。	Normal 34 36 打猎
英国方面同时入场并登上主席台主礼台的有查尔斯王子、首相布莱尔、外交大臣库克、离任港督彭定康、国防参谋长查尔斯·格思里。	Normal 6 8 入场
让他们的床铺得跟你们的床同样柔软，让他们的舌头也尝尝你们所吃的东西吧，你们会回答说："这些奴隶是我们所有的。"	Normal 4 6 床铺
1900年，“八国联军”入侵北京，最后一群麋鹿惨遭厄运，有的被杀戮，有的被装上西去的轮船。	Normal 23 25 惨遭
试看今日的天下，各种政治、军事、外交斗争，表面上尽管五花八门、刁钻古怪，但变来变去，其精神实质，有多少能超出这两本书的范围！	Normal 52 54 超出
这个像跳蚤一般大的小动动物在线上摇荡，以防在硬地上摔伤。	Normal 13 15 在线
活人的塑像和大理石的塑像有一点不同，刀法如果用得不对，可以万像同毁，刀法如果用得对，则一笔下去，万龙点睛。	Hard 29 33 万像同毁
“作善降祥”的古训，六朝人本已有些怀疑了，他们作墓志，竟会说“积善不报，终自欺人”的话。	Hard 36 40 终自欺人
）老人一声不响，却笑呵呵地伸手在烘缸里取出一个小小的烤山薯，往我手里一放说：“给你吃。”	Hard 16 18 烘缸
据说他当初行为不正，糟蹋钱。	Hard 10 12 糟蹋
我家的厨师是一个足智多谋的人，除了调和鼎鼐之外还贯通不少的左道旁门，他因为厨房里的肉常常被猫拖拉到灶下，鱼常被猫叼着上了墙头，怀恨于心，于是殚智竭力，发明了一个简单而有效的捕猫方法。	Hard 17 21 调和鼎鼐
这里太好玩了，还有好吃的鳕鱼。	Normal 3 5 好玩
不必再注视那些暴露四野的破碎的鸟尸，也无须再回忆严寒中沉闷的响雷，以及重压在我们身上的酷冷。	Normal 27 29 沉闷
它不同于：“美女妖且闲，采桑歧路间；柔条纷冉冉，落叶何翩翩。”	Hard 12 17 采桑歧路间
他们在座舱里飘来飘去，仔细地检查一个个仪器，还不时地和地面指挥中心联络着……	Normal 11 13 仔细
只见云气氤氲来，飞升于文殊院，清凉台，飘拂过东海门，西海门，弥漫于北海宾馆，白鹅岭。	Hard 4 6 氤氲
第一年里，他们共同从事镭和钋的化学离析工作，并且研究他们所得到的活性产物的放射性。	Hard 13 14 钋
他发现，他的影子慢慢褪去了黑色，变成了一个衣着美丽的孩子，也有着一样红润的圆脸、油亮的头发和大大的黑眼睛。	Normal 34 36 红润
“年”见了桃符，听到爆竹响，吓得赶快逃跑，这样大家就安然无恙了。	Normal 16 18 赶快
其出不出，间不容发。	Hard 0 4 其出不出
离窠外出寻找花蜜的单个蜜蜂(根据一个跳舞的小蜂给它的指令：“去南偏东南七百米，有苜蓿——注意根据太阳偏转调整方向”)仍然是如同有细丝系住一样属于蜂窠的一部分。	Hard 40 42 苜蓿
德诺十岁那年因为输血不幸染上了艾滋病，伙伴们全都躲着他，只有大他四岁的艾迪依旧像从前一样跟他玩耍。	Normal 46 48 玩耍
在盛夏的烈日下，你又给人们送出暑天的凉风。	Normal 11 13 人们
次年四月，清兵包围了扬州。	Hard 5 7 清兵
于是，伯父家盖房，想以它垒山墙，但苦于它极不规则，没棱角儿，也没平面儿；用錾破开吧，又懒得花那么大气力，因为河滩并不甚远，随便去掮一块回来，哪一块也比它强。	Hard 37 38 錾
请您赏脸把这件衬衫穿上，还有这套衣服；正合适，好极了——又素净，又讲究，又雅致，简直就像个公爵穿得那么考究。	Normal 16 18 衣服
据现在对金星观测所知，它的大小、质量、构成都与地球相似，但它却是个被厚厚大气层笼罩着的、表面温度高达480摄氏度的死星。	Normal 36 39 大气层
扫开一块雪，露出地面，用一枝短棒支起一面大的竹筛来，下西撒些秋谷，棒上系一条长绳，人远远地牵着，看鸟雀下来啄食，走到竹筛底下的时候，将绳子一拉，便罩住了。	Normal 49 51 鸟雀
桐城派的文体以“味淡声希，整洁从容”自矜，也难怪表情较平，节拍较缓。	Hard 18 20 自矜
当时三人坐下，李逵便道：“酒把大碗来筛，不奈烦小盏价吃。”	Hard 14 15 把
我想，不止是这江面上众多的升帆的货船和鸣笛的汽轮，那来往穿梭的舢板和驳船，不止是停泊在江心的钻探船，不止是下关码头两旁长长的仓库、堆栈和高楼，使你的心好像黎明一般的欢畅，青春一般的欢愉。	Normal 68 70 高楼
手术完成之后，用相同频率的电脉冲刺激换核卵，让苏格兰黑面羊的卵细胞质与芬多席特母羊乳腺细胞的核相互协调，使这个“组装”细胞在试管里经历受精卵那样的分裂、发育而形成胚胎的过程。	Hard 10 12 频率
于是六国之士，有宁越、徐尚、苏秦、杜赫之属为之谋，齐明、周最、陈轸、召滑、楼缓、翟景、苏厉、乐毅之徒通其意，吴起、孙膑、带佗、倪良、王廖、田忌、廉颇、赵奢之伦制其兵。	Hard 37 39 楼缓
在环境激变的今天，我们应该重新体会到几千年前经书里说的格物致知真正的意义。	Normal 15 17 体会
爸爸就在我身边，他的大手经常扶住我的身子，也经常托住我的脚掌——我慢慢地爬，常常紧伏在树身上一动不动，等力气有了再爬。	Normal 24 26 托住
执行死刑的六个枪手在爬满常春藤的墙前站成一排，这墙就是他那天夜晚进行不幸尝试时爬过的布满裂维正要坍塌的墙壁。	Hard 44 46 裂维
次日早起五更，在府里把担仗都摆在厅前，老都管和两个虞候又将一小担财帛，共十一担，拣了十一个壮健的厢禁军，都做脚夫打扮。	Hard 11 13 担仗
这时，宇航员们感到自己的身体轻飘飘的，无法在座舱里站稳，稍一抬脚，就会跳起三四米高。	Hard 22 24 座舱
不但如此，知道了景物各有个性的差别，我们就应该明白：因袭的词章套语决不够用来描写景物，因为套语总是浮泛的，笼统的，不能表现某地某景的个别性质。	Normal 8 10 景物
那王小玉唱到极高的三四叠后，陡然一落，又极力骋其千回百折的精神，如一条飞蛇在黄山三十六峰半中腰里盘旋穿插，顷刻之间，周匝数遍。	Hard 58 61 周匝数
每次走在它下面，闻到淡淡的幽香，听到嗡嗡的蜂声，顿觉这个世界还是值得留恋的，人生还不全是荆棘丛。	Normal 16 18 听到
当日林如海教女以惜福养身，云饭后务待饭粒咽尽，过一时再吃茶，方不脾胃。	Hard 20 22 咽尽
至于苗、瑶族则尚青黑而爱彩色，也比较懂色彩，因此使用到衣裙上的挑花，多用青布作地，上加彩线或棕黄绿，即同属一地区挑花，艺术效果也显然不同。	Hard 7 8 尚
“老爷子，也该叫你的这毡靴退休啦，该送给乌鸦造窝去啦。”	Normal 1 4 老爷子
一个人哪怕朋友遍天下，只要他对其中一个朋友有背信弃义的行径，我们就有充分的理由怀疑他是否真爱朋友，因为一旦他认为必要，他同样会背叛其他的朋友。	Normal 3 5 哪怕
这个鳏夫两只眼睛睁得老大，愣在那儿，一下子糊涂了。	Hard 2 4 鳏夫
老太婆更是刻毒，对她儿子说：‘你学屠宰好多年了，为什么不把刀磨磨？	Normal 0 3 老太婆
也许是这里的奇峰交给他一副傲骨，这位比李白还老的疯诗人太不安分，长剑佩腰，满脑奇想，纵横中原，问天索地，最终投身汨罗江，一时把那里的江水，也搅起了三峡的波涛。	Normal 52 54 最终
时云长在侧曰：“某闻管仲、乐毅乃春秋、战国名人，功盖寰宇；孔明自比此二人，毋乃太过？”	Hard 29 36 孔明自比此二人
“男爵爱卿，”他厉声言道，“朕想卿也明白，‘陛下’这个称呼在全国范围内只属于孤家一人，再没有旁人称得起‘陛下’了！	Hard 8 10 厉声
他们指着，描述着一些美丽的花纹棗事实上它们并不存在。	Hard 13 16 花纹棗
郑屠道：“着人与提辖拿了，送将府里去。”	Normal 13 14 送
据说住在竹楼上面，急雨声如瀑布，密雪声比辟玉。	Hard 19 22 比辟玉
至于雨敲在鳞鳞千瓣的瓦上，由远而近，轻轻重重轻轻，夹着一股股的细流沿瓦槽与屋檐潺潺泻下，各种敲击音与滑音密织成网，谁的千指百指在按摩耳轮。	Hard 50 52 滑音
至于视觉经验，也都表现得很有动感：写荷花迎风则“红披绿偃，摇荡葳蕤”，写微风拂水则“细生鳞甲”，写流萤则“（幽火）班班，若骇若惊，奄忽去来”，写山则“森森欲下搏人”。	Hard 29 33 摇荡葳蕤
后来它们言归于好，又开始像原先那样痴呆地进行工作，但是那只瘸腿的蚂蚁老大吃亏，无论它怎样使大劲拽，另一只蚂蚁仍旧把那胜利品连同吊在末端上的它一起拉了过去。	Normal 32 34 蚂蚁
贾里悄悄地写了封自我推荐信，没化名，但把年龄往上浮动了四周岁。	Normal 20 22 年龄
皮鞋匠静静地听着。	Normal 3 6 静静地
沙山的斜坡很是舒缓，牛毛般光泽细软，而线条清晰有如刀刃般的山脊无论直线还是弧度，都高贵得不可企及。	Normal 25 27 刀刃
许先生很镇静，没有紊乱的神色，虽然说那天当着人哭过一次，但该做什么，仍是做什么，毛线该洗的已经洗了，晒的已经晒起，晒干了的随手就把它缠成团子。	Normal 57 59 晒干
但自从被《申报》重金礼聘去当总编辑以后，也许是四为报受到立完派的张謇等影响过多、控制过严吧，他以“冷”的署名写的“时评”和“小言”，吞吞吐吐，有时简直不知所云，真如一般人批评的，看了像读《太上感应篇》一般，《时事新报》有署名“东荪”的评论，似乎言之有物，但文词啰嗦，不着边际。	Hard 32 34 张謇
又转回头来望着女儿，说道：“我早上拿了钱来，你那该死行瘟的兄弟还不肯，我说：‘姑老爷今非昔比，少不得有人把银子送上门来给他用，只怕姑老爷还不稀罕。’	Hard 26 28 行瘟
就这样，这些并不引人注目的蒲公英，给我们带来了不少快乐。	Normal 25 27 快乐
合众国总统将在白宫亲自把那一克儒赠给你。	Hard 13 16 一克儒
否则，鸠占鹊巢，李代桃僵，那屋内必是鸡飞狗跳，不得安宁。	Hard 8 12 李代桃僵
老汉冷冷地说：“可以退党，到我这儿报名。”	Normal 0 2 老汉
这位善良的老大臣因此就来到那两个骗子的屋子里，看到他们正在空织布机上忙碌地工作着。	Normal 16 18 骗子
他的脸上呈现出悲剧，一张含蓄了许多愁苦和力量的脸；火一样蓬勃的头发，盖在他的头上，好像有生以来从未梳过；深邃的眼睛略带灰色，有一种凝重不可逼视的光；长而笨重的鼻子下一张紧闭的嘴，衬着略带方形的下颏，整个描绘出坚忍无比的生的意志。	Hard 96 98 下颏
许多同学都跟着一起背起来：“人有悲欢离合，月有阴晴圆缺，此事古难全。”	Hard 23 27 阴晴圆缺
像鸽子笼一般地分得均匀，每边八排，每排五户，一共八十户一楼一底的房屋，每间工房的楼上楼下，平均住着三十二三个“懒虫”和“猪猡”，所以，除了“带工”老板、老板娘、他们的家族亲戚和穿拷绸衣服的同一职务的打杂、请愿警之外，这工房区域的墙圈里面住着二千左右衣服褴褛而替别人制造衣料的“猪猡”。	Hard 89 91 拷绸
拉头大喊了一声，这么一来，那鬼影真就不动了。	Hard 0 2 拉头
拿莫温学着同样生硬的调子说：	Normal 7 9 生硬
她勤俭持家，精打细算，因而他们的日子好像过得很阔绰。	Normal 18 20 好像
李逵也不答应他，便就地下掳了银子，又抢了别人赌的十来两银子，都搂在布衫兜里，睁起双眼说道：“老爷闲常赌直，今日权且不直一遍。”	Hard 50 52 赌直
杨志道：“深谢恩相抬举。”	Hard 7 9 恩相
巢窠散落在地面上，小耗子又会发现它们，将毡靴的残毛搬进自己地下的窝中。	Hard 20 22 毡靴
在进入大道的岔道上，是众多仆从簇拥的轿乘队伍，从插满柳枝的轿顶可知是踏青扫墓归来的权贵，近处小路上骑驴而行的则是长途跋涉的行旅。	Normal 3 5 大道
老头儿看见两个褐色的鳍顺着死鱼的水里所不得不造成的那条宽阔的路线游着。	Hard 10 11 鳍
在扎伊尔维龙加天然动物园时在，有七彩的巨蟒、黑白相间的斑马，有数不清的经羽鸟、各种颜色交织的五彩鸟，有美丽温顺的梅花鹿，更有非洲雄狮、河马、金钱豹和象群。	Normal 70 73 金钱豹
三峡，注定是一个不安宁的渊薮。	Hard 12 14 渊薮
不错，科学家们提出了许多设想，例如，在火星或者月球上建造移民基地。	Normal 23 25 月球
田间与灌木篱下，横陈着田凫、椋鸟、画眉等数不清的腐鸟的血衣，鸟儿的肉已被隐秘的老饕吃净了。	Normal 0 2 田间
那七人道：“你这汉子忒认真！	Hard 10 11 忒
那是暑假里的一天，我闹着要舅舅带我去赶海，舅舅答应了。	Hard 18 20 赶海
物候现象的来临决定于哪些因素呢？	Hard 0 4 物候现象
现在她只剩了一个光身了。	Hard 8 10 光身
在我眼前出现的不是摇头摆尾、连连作揖的小狗，而是躺在解剖桌上给割开肚皮的包弟。	Normal 2 4 眼前
所以家乡老辈都说我“像个先生样子”，遂叫我做“穈先生”。	Hard 23 26 穈先生
妙极了，它真没有走去，我们很快就在葡萄叶儿上，磁花盆儿上，爷爷的锨刃儿上发现了。	Hard 32 35 锨刃儿
一种浓酽的悔意涌上心头，他想马上找到那不见身影的老人，把钱包奉还……	Hard 2 4 浓酽
他生就一副多毛的脸庞，植被多于空地，浓密的胡髭使人难以看清他的内心世界。	Hard 21 23 胡髭
少焉，月出寒阴，微明散布石上，松声倏然自万壑来，客皆悚视寂，觉境愈清，思愈远。	Hard 3 7 月出寒阴
杨志提了朴刀，拿着藤条，自去赶那担子。	Normal 0 3 杨志提
道上有个路亭，我们每次走到路亭里，必定坐下来休息一会儿。	Normal 17 19 必定
接着，江泽民主席走到镶嵌着中华人民共和国国徽的讲台前发表讲话。	Normal 0 2 接着
我们现在已经回到了我们的后院——离地球1光年的地方。	Hard 20 22 光年
为了造成这样的麻醉，膜翅目猎手使用了当今先进科学可能会向实验生理学家建议的办法，即借助有毒的螫针破坏指挥运动器官的神经中枢。	Hard 57 61 神经中枢
黄与绿主宰着，无边无垠，坦荡如砥，这时如果不是宛若并肩的远山的连峰提醒了你(这些山峰凭你的肉眼来判断，就知道是在你脚底下的)，你会忘记了汽车是在高原上行驶。	Hard 12 16 坦荡如砥
另外，饲料发酵，奶酪、酸奶、酸菜等食品的制作，有机垃圾通过腐烂成为植物的营养肥料，都与细菌有着密不可分的联系。	Normal 11 13 酸奶
至于视觉经验，也都表现得很有动感：写荷花迎风则“红披绿偃，摇荡葳蕤”，写微风拂水则“细生鳞甲”，写流萤则“（幽火）班班，若骇若惊，奄忽去来”，写山则“森森欲下搏人”。	Hard 75 81 森森欲下搏人
市内之枯燥嘈杂，既不适于居住，也渐不适于工作，游息的空地都被密集的建筑物和街市所侵占，人民无处游息，各种行动都忍受交通的拥挤和困难。	Normal 10 12 适于
看，蓝天上的大雁作出了回答，它们排成一个大大的“人”字，好像在说——勤劳的人们画出秋天的图画。	Normal 6 8 大雁
“我需要一克镭，以便继续我的研究，但是我买不起，的价格太高了。”	Hard 6 7 镭
一边还咄念道：“等得住你！”	Hard 3 5 咄念
我们很费力地把口袋擒到楼下。	Hard 9 10 擒
一阵窸窸窣窣的声音，每个人都拿出讲义，端端正正摆在面前。	Normal 0 2 一阵
险绝处的红漆栏杆，本身便是可美的风景。	Normal 6 8 栏杆
我费力地从里衫的袋里(公司为防止我们“揩油”，衣衫上一只袋都没有缝)掏出那块带着体温的银元，放到他的手里——他的手多瘦啊！	Normal 1 3 费力
昆虫采蜜传粉，有一特殊的习性，就是经常只采访同一种植物的花朵。	Normal 0 2 昆虫
“好倒霉啊，”渔夫叫道，“碰上我来解救你！	Normal 7 9 渔夫
我独自一人游荡在田野里。	Normal 8 10 田野
音乐，是撩动人们心情的“神仙的手指。	Normal 12 14 神仙
后来他又发明了耒、耜，告诉人们如何耕种。	Normal 0 2 后来
姚文的“下有红光，动摇承之”十分高明，把动感表现得灵活之至。	Hard 6 8 红光
你们看它矮辞退地长在地上，等到成熟了，也不能立刻分辨出来它有没有果实，必须挖起来才知道。	Normal 32 34 果实
考察队员和村民们认真仔细地搜索、观察,在附近一共发现了七只成年朱鹮,他们立即投入到紧张的保护朱鹮的工作之中。	Hard 46 48 朱鹮
寂然饭毕，各有丫鬟用小茶盘捧上茶来。	Hard 0 2 寂然
有时候也由首相一个人拿着木棍。	Normal 12 14 木棍
宋朝的时候,有一回黄河发大水,冲断了河中府城外的一座浮桥。	Hard 26 28 浮桥
是天气比往年热呢，还是自己的身体虚呢？	Normal 4 6 往年
制造原子弹的工作异常危险，尤其是插雷管，万一发生问题，所有在场的人霎时就会化为灰烬。	Hard 17 19 雷管
他在田边焦急地转来转去，自言自语地说:“我得想个办法帮它们长。”	Normal 7 11 转来转去
当时嘉定名“药斑布”，苏州名“浇花布”，《醉金》一书中则名“浆水缬”，生产实具全国性。	Hard 30 33 浆水缬
我不禁头涔涔而泪潸潸了。	Hard 7 10 泪潸潸
相反，如果神经节都连在一起，那么只要损坏共同的神经节，就会使神经分枝所分布的所有节段瘫痪。	Normal 35 37 分布
我越发神气，大刀呼呼抡两圈，摆个张牙舞爪的架势，逗得客人们笑个不停。	Normal 1 3 越发
为了改良花卉的颜色、香味、形状和保鲜期等多方面的性状，科学家们的思路是首先要了解这些性状的生理机制，进而找到并克隆出与之直接或间接相关的各种基因，深入研究这些基因后，再修饰并转入到需要改良品质的花卉中，从而定向创造出花卉新品种。	Hard 4 6 花卉
为了造成这样的麻醉，膜翅目猎手使用了当今先进科学可能会向实验生理学家建议的办法，即借助有毒的螫针破坏指挥运动器官的神经中枢。	Hard 46 48 螫针
还有小狗做算术，猴子骑车，马钻火圈，都挺有趣。	Normal 5 7 算术
周总理一手端着盛满清水的银碗，一手拿着柏树枝蘸了水，向人们泼洒，为人们祝福。	Normal 35 37 祝福
过了不久，居然有一个专人，骑着自行车来给我送报了，这三块钱花得真是气派。	Normal 5 7 居然
说时迟，那时快，武松见大虫扑来，一闪，闪在大虫背后。	Hard 11 13 大虫
若有好几只，它不放心一只只带过去，怕它在河里游的时候，留在岸边的“子女”会出什么事，于是狼就咬死一只动物，把那动物的胃吹足了气，再用牙齿牢牢紧住蒂处，让它胀鼓鼓的好似一只皮筏，它把所有的小狼背负在身上，借着那“救生圈”的浮力，全家过河。	Normal 105 108 救生圈
及至始皇，奋六世之余烈，振长策而御宇内，吞二周而亡诸侯，履至尊而制六合，执敲扑而鞭笞天下，威振四海。	Hard 16 19 御宇内
我把第二个烟头啐了出去，落到干草垫之间的过道里。	Hard 7 8 啐
1910年他加入同盟会，筹款资助孙中山先生领导的辛亥革命；抗日战争爆发，他担任南洋华侨总会主席，捐资抗日，不顾危险，亲身回国考察战事、慰劳将士。	Hard 41 43 华侨
雨季则有青头菌、牛肝菌，味极鲜腴。	Hard 14 16 鲜腴
一个夏天，太阳暖暖地照着，海在很远的地方翻腾怒吼，绿叶在树顶上飒飒地响。	Normal 25 27 绿叶
许多来华的外国人,离开时总不忘买几个中国结,准备送给亲朋好友。	Normal 24 26 送给
（《礼记・坊记》）范仲淹所说“先天下之忧而忧，后天下之乐而乐”＂（《岳阳楼记》）也体现了这种精神。	Hard 23 30 后天下之乐而乐
一切我都不要了，只愿像一片没有了生命力的敗叶一样，往下飘，飘。	Normal 16 19 生命力
它的成分并不和一般通用的意义一样，里面是较少的籼米、锅焦、碎米和较多的乡下人用来喂猪的豆腐渣！	Hard 26 28 锅焦
看着这个比我还小两岁的小鬼头那么能干，我怕别人笑话话自己，只好跳下树，跟着柚根子走了。	Hard 37 40 柚根子
人们在路基旁边疯狂地掘着土，铁器沉重地咚咚响着，铁锹碰着石头，发出了喀嚓喀嚓的声音。	Normal 14 16 铁器
我瞪着眼睛，想看个究竟。	Normal 3 5 眼睛
及至始皇，奋六世之余烈，振长策而御宇内，吞二周而亡诸侯，履至尊而制六合，执敲扑而鞭笞天下，威振四海。	Hard 8 11 之余烈
我眼看见儿时的伴侣中的英雄、好汉，一个个退缩、顺从、妥协、屈服起来，到象绵羊的地步。	Normal 23 25 顺从
这些或许是它被冠名为“神木”的原因吧。	Normal 2 4 或许
我突然陷入沉思，眼前这个小小的壶口，怎么一下子集纳了海、河、瀑、泉、雾所有水的形态，兼容了喜、怒、哀、怨、愁，人的各种感情。	Normal 39 41 形态
爸爸竟然也说不出它是什么树，一会儿说是“桧树”，一会又说恐怕是“槭树”，都是奇怪的名称；他只说他小时候就经常来爬它，他们那群小孩子管它叫“大不列颠”，真是莫名其妙。	Hard 32 34 槭树
我不留大胡子是因为，如果在突发事件中我需要带上防毒面具，胡子可能会阻碍全脸面具的密封。	Normal 28 30 胡子
1月18日，斯科特海军上校和他的四名伙伴到达极点。	Normal 16 18 四名
透明的冰山，沸腾的大海，汹涌澎湃的大江大河，丁丁冬冬的泉水，潺潺的溪流，平静的湖水，北国千里冰封，万里雪飘，南国溟溟薄雾，潆漾细雨，还有那挂在红花绿叶上珍珠般晶莹的晨露，蓝天上飘浮的白云，以及危害庄稼的冰雹，所有这一切，气态的、固态的、液态的水，都是水的不同形态。	Hard 56 60 溟溟薄雾
像鸽子笼一般地分得均匀，每边八排，每排五户，一共八十户一楼一底的房屋，每间工房的楼上楼下，平均住着三十二三个“懒虫”和“猪猡”，所以，除了“带工”老板、老板娘、他们的家族亲戚和穿拷绸衣服的同一职务的打杂、请愿警之外，这工房区域的墙圈里面住着二千左右衣服褴褛而替别人制造衣料的“猪猡”。	Hard 60 62 猪猡
不过，他老是吸吮着，咀嚼着那只小驯鹿的碎骨头，这是他收集起来随身带着的一点残屑。	Normal 26 28 收集
有的队员用声波探测仪仔细搜索着每一条缝隙，细心地捕捉着废墟里发出的声音；有的队员操作液压钳，剪断纵横交错的一根根钢筋，搜寻着压在废墟下的幸存者……	Normal 33 35 声音
别看它又大又重，却能在空中飞翔自如。	Normal 11 13 空中
比如“两岸青山相对出，孤帆一片日边来”，豪情雄壮，比如“青山一道同云雨，明月何曾是两乡”，比如“白日依山尽”，“大漠孤烟直”，“黄河之水天上来，奔流到海不复回”，比如“孤帆远影碧空尽，惟见长江天际流”，比如“无边落木萧萧下，不尽长江滚滚来”，都力量充沛得很，生命强健得很。	Hard 36 43 明月何曾是两乡
用最精细确定的形式来逗出不可名言、难于凑泊的境界，恰符合魏尔兰论诗的条件：	Hard 17 21 难于凑泊
“自从1945年起，每年10月21日，成千上万的人从四面八方来到克拉库耶伐次，悼念被纳粹杀死的300个孩子。”	Normal 1 3 自从
中国有句古话：“敬业乐群。”	Hard 8 12 敬业乐群
刘姥姥又给贾母辞行，鸳鸯将众人送她的几大包东西给她，叫了车，让小厮送刘姥姥回乡下去了。	Hard 10 12 鸳鸯
如果别处都有搭石，唯独这一处没有，人们会谴责这里的人懒惰。	Normal 2 4 别处
齐鲁青未了”，这“青未了”三个字，不正是生生不息的春色天边无际地流淌么？	Normal 18 20 正是
黄河及其支流泛滥过后，造就了大面积肥沃的土地，特别适合种植粟黍一类旱地作物；可是泛滥的河水，时常给人畜带来灾害。	Hard 29 31 粟黍
他转身盯了我一眼说：“那好，跟我来。”	Normal 1 3 转身
又如大家所熟悉的范仲淹的《岳阳楼记》：“若夫淫雨霏霏，连月不开。	Normal 5 7 熟悉
小刺猬连忙从背上取下两个大苹果，对小獾说：“留下吧，这也是我的一点儿心意！”	Hard 18 19 獾
联邦主席、女士们、先生们：	Hard 0 2 联邦
她看我还没有起来，吓了一跳，催促着我。	Normal 6 8 起来
我并不以为我的儿子会是一无所知、一无所能的白痴，但纵然是一无所知一无所能的白痴，也仍旧是太子或王子。—	Normal 21 23 白痴
保尔在海边找了张长発坐下，把脸对着日光，太阳已不那么晒人了。	Hard 8 10 长発
古丽拜尔婶婶笑容可掬地给我们斟上奶茶，阿伊霞姐姐给我拿来馓子，阿吉让我先尝尝无花果……	Hard 28 30 馓子
有拔木转石的兽力和惊天动地的神威，中国诗绝不是贵国惠特曼所谓“野蛮犬吠”，而是文明人话。	Normal 37 39 而是
我用鞭子着实教训了它一顿。	Normal 2 4 鞭子
更兼单身客人，亦不敢独自经过。	Hard 0 2 更兼
即使荒野露宿，栖身洞穴，也要“燃松拾穗，走笔为记”。	Hard 20 24 走笔为记
如果我们换一个角度来看事物怎样改变了名称，那么首先引起我们注意的是，像前边分析《战国策》那一段文字的时候已经讲过的，很多古代的单音词现代都多音化了。	Normal 35 37 前边
这时，普鲁士军队操练回来的军号声在我们窗前响了起来……	Normal 10 12 回来
扁担一压上红肿的肩头，头上就直冒冷汗。	Normal 8 10 肩头
经过长期细心的观察、揣摩，文与可对竹子的特性了如指掌，胸中积累了各种竹子的形象。	Normal 17 19 竹子
当飞机起飞时，下面还是黑沉沉的浓夜，上空却已游动着一线微明，它如同一条狭窄的暗红色长带，带子的上面露出一片清冷的淡蓝色晨曦，晨曦上面高悬着一颗明亮的启明星。	Hard 27 29 微明
深秋的威尼斯，绚丽多姿，游客如云，广场上千百只灰鸽争相啄食，供人拍照、逗乐；穿梭般来往的船艇，迎着飞翔的海鸥，构成一幅美丽、和谐、幸福的画卷。	Normal 0 2 深秋
茶罢，孔明曰：“昨观书意，足见将军忧民忧国之心；但恨亮年幼才疏，有误下问。”	Hard 17 21 忧民忧国
每见我伸手欲揽其近前，她必远远地跑开，仰起笑脸逗我；待我佯作冷淡而不顾，她却又悄悄跑近，偎我腰间。	Normal 21 23 笑脸
同样的道理，革命样板戏宣称要打倒的那些旧时代文艺，那些以前也在这里上演过的剧目，同这些观众有没有关系或者有多大的关系？	Normal 14 16 打倒
胶皮笔囊内没有夹管，吸墨水时，捏一下，鼓起缓慢。	Hard 2 4 笔囊
曾子还说哩：“任重而道远”，“死而后已，不亦远乎！”	Normal 2 3 还
茶罢，孔明曰：“昨观书意，足见将军忧民忧国之心；但恨亮年幼才疏，有误下问。”	Hard 27 31 年幼才疏
又经过了很长很长的年代，它们的前肢和尾巴渐渐变成了鳍，后肢完全退化了，整个身子成了鱼的样子，适应了海洋的生活。	Hard 25 26 鳍
例如《诗经·鲁颂》的《駉》这一首诗里提到马的名称就有16种：“驈”(身子黑而胯下白的)，“皇”(黄白相间的)，“骊”(纯黑色的)，“黄”(黄而杂红的)，“骓”(青白杂的)，“駓”(黄白杂的)，“騂”(红黄色的)，“骐”(青黑成纹像棋道的)，“驒”(青黑色而有斑像鱼鳞的)，“骆”(白马黑鬃)，“駵”(红马黑鬃)，“雒”(黑马白鬃)，“駰”(灰色有杂毛的)，“騢”(红白杂毛的)，“驔”(小腿长白毛的)，“鱼”(两眼旁边毛色白的)。	Hard 107 108 骐
在一秒钟之内，我们就把枪弹上了膛，过度的兴奋竟使我们无法瞄准。	Normal 17 19 过度
这工作好好玩，所以我盼望天一直不要晴起来，曲会愈来愈多，我就可以天天滚在谷子里拣曲，不用读书了。	Hard 39 41 拣曲
我梦想有一天，亚拉巴马州能够有所转变，尽管该州州长现在仍然满口异议，反对联邦法令，但有朝一日，那里的黑人男孩和女孩将能与白人男孩和女孩情同骨肉，携手并进。	Normal 52 54 男孩
古今多少奇丈夫	Hard 4 7 奇丈夫
然后，鼓锣暂停，船上、岸边的人们聚精会神地扫视着水面，鸭子一露面，立刻喊声乍起，各船迅速拨转船头重新“围剿”，水面立时锣鼓喧天。	Normal 21 23 扫视
即使克隆人的一些理由本身可以成立(例如解决不育、防止显性遗传病)，一且迈出克隆人的第一步，后面就很难阻挡。	Hard 26 28 显性
我呆呆地望着来来往往吊唁的人，想到我从此永远见不到伯父的面了，听不到他的声音了，也得不到他的爱抚了，泪珠就一滴一滴地掉下来。	Hard 10 12 吊唁
我便一点不迟疑答道：“百行业为先，万恶懒为首。”	Normal 5 7 迟疑
突然，一个红气球摇摇摆摆地飘了上来，在科利亚房间的窗户前停住了。	Normal 6 8 气球
哥伦布是16世纪意大利伟大的航海家，他常常带领船队在大西洋上乘风破浪，远航探险。	Normal 14 17 航海家
他站着没劲，独自玩起了手影戏。	Normal 3 5 没劲
嗉囊装满后，它用喙尖抓抓脚底，用沾着唾液的爪擦擦脸和眼睛，然后闭着双眼或者躺在沙上消化食物。	Hard 8 9 喙
那王小玉唱到极高的三四叠后，陡然一落，又极力骋其千回百折的精神，如一条飞蛇在黄山三十六峰半中腰里盘旋穿插，顷刻之间，周匝数遍。	Normal 29 31 精神
（四）斗拱：在一副梁架上，在立柱和横梁交接处，在柱头上加上一层层逐新挑出的称做“拱”的号形短木，两层拱之间用称做“斗”的斗形方木块垫着。	Hard 3 5 斗拱
但她大概也即觉到了，说道：“像你似的小孩子，长毛也要掳的，掳去做小长毛。	Hard 29 30 掳
它们是最简单的土生土长的动物，与大自然同色彩、同性质，和树叶、和土地是最亲密的联盟。	Normal 28 30 树叶
“要是我能像小鸟那样，用翅膀在天空中飞翔多好啊！	Normal 6 8 小鸟
你们看它矮辞退地长在地上，等到成熟了，也不能立刻分辨出来它有没有果实，必须挖起来才知道。	Normal 22 24 立刻
这样有趣的云总是常常见到的，但是把整个大地盖住的“茫茫云海”却不是常见到的。	Normal 21 23 盖住
我暗暗地在那里匿笑，却一声儿不响。	Normal 1 3 暗暗
孩子们用龙眼核给他做眼珠，又从谁的母亲的脂粉奁中偷得胭脂来涂在嘴唇上。	Hard 20 23 脂粉奁
她把这些沸腾的液体填补在天空的缺口上。	Normal 7 9 液体
恭喜您，是个男伢子，少爷！	Hard 7 9 伢子
鲁肃听了非常高兴，他对吕蒙说：“我以为你还是个大老粗呢，想不到你已经变成了学问家，真不是过去的吕蒙了！”	Hard 23 26 大老粗
至谷底，我们坐在水边的一块岩石上，隔着一口小小的绿潭，那一幅白帘般的瀑布，仿佛一伸手便可撩过来拭脸似的，它跃入涧底激起的烟雾般的水珠，直扑到我们脸上，沁凉沁凉的。	Normal 8 10 水边
马萨诸塞州的伦萨姆仿佛与我有不解之缘，我生命中所有的欢乐和忧愁，也似乎都与这个地方连在一起。	Normal 29 31 忧愁
我眺望四周，一片茫无边际的蔚蓝的海，无数波浪闪耀着金鳞；头上，也是这样茫无边际，这样蔚蓝的海——在那儿，温柔的太阳在运行着，宛然在微笑。	Normal 20 22 波浪
将受到历史制裁的这两个强盗，一个叫法兰西，另一个叫英吉利。	Normal 1 3 受到
他是个非常有趣的瘦小的老头儿，六十五岁，老是笑眯眯地眨着眼睛。	Normal 11 14 老头儿
真君笑道：“那猴儿才自变座土地庙哄我，我正要捣他窗棂，踢他门扇，他就纵一纵，又渺无踪迹。	Hard 24 26 窗棂
因这年秋尽冬初，天气冷将上来，家中冬事未办，狗儿未免心中烦躁，吃了几杯闷酒，在家里闲寻气恼，刘氏不敢顶撞。	Hard 35 37 闷酒
很显然，这个窗户俯瞰着一座公园，公园里面有一泓湖水，湖面上照例漫游着一群群野鸭、天鹅。	Hard 21 23 一泓
早晨起来，就淅淅沥沥的，我还高兴地说：“春雨贵如油；今年来得这么早！”	Hard 20 25 春雨贵如油
因为我太小，拿不动锄头杆，祖父就把锄头杆拔下来，让我单拿着那个锄头的“头”来铲。	Normal 13 15 祖父
这激怒了英雄惹地豪星，决心把这个恶差除掉。	Hard 16 18 恶差
但是看到舷窗玻璃开始出现裂缝，我紧张了，心想：完了，这个舷窗不行了。	Hard 4 6 舷窗
希特勒把他们送进了死亡深渊。	Normal 6 8 送进
人们一般都愿意以无比钦佩的心情，提及梁思成在第二次世界大战期间为日本名城奈良免遭轰炸所作出的努力。	Normal 16 18 提及
只见黛玉正拿着诗和他讲究。	Hard 10 12 讲究
不是我口浅，量你是个遭死的军人，相公可怜，抬举你做个提辖，比得草芥子大小的官职，直得恁地逞能。	Normal 18 20 可怜
胡屠户上前道："贤婿老爷，方才不是我敢大胆，是你老太太的主意，央我来劝你的。"	Normal 10 12 老爷
四百多年里，它一面剥蚀了古殿檐头浮夸的琉璃，淡褪了门壁上炫耀的朱红，坍圮了一段段高墙又散落了玉砌雕栏，祭坛四周的老柏树愈见苍幽，到处的野草荒藤也都茂盛得自在坦荡。	Normal 28 30 炫耀
自然，也可以扩大精神，增加智识的，但这些倒都不计及，一计及，便等于意在赢钱的博徒了，这在博徒之中，也算是下品。	Hard 23 25 计及
上星期，于老师布置了一项作业：到大自然去找春天，并把找到的春天带到教室里。	Normal 33 35 教室
张连长笑眯眯地问海娃：“好些吗？	Normal 12 14 好些
这时，数十只幼龟已成了嘲鸫、海鸥、铿鸟的口中之食，我们的向导摘下头上的棒球帽，迅速抓起十数只幼龟，放进帽中，向海边奔去。	Hard 11 13 嘲鸫
象鞍上留着弹洞，似乎还有斑斑血迹，混合着一股皮革、硝烟、战尘和血液的奇特气味；象鞍的中央有一个莲花状的座垫，四周镶着一圈银铃，还缀着可黄色的流苏。	Normal 51 53 座垫
唐朝的都城长安是当时最大的国际都会，在人世纪前半叶，人口已经达到百万之多，居住着不少任职于唐朝的外国人、留学生、学问僧、求法僧、外国的艺术家，以及大量外来的商贾。	Hard 15 17 都会
这是数以千计的照片，是囚徒们的照片。	Normal 15 17 照片
但是让我们剖开一只蟋蟀看看吧。	Hard 9 11 蟋蟀
中学地理课本向我展示由外太空拍摄到的卫星图片：藏蓝的深渊里，地球孤独地转动，布满褐色的古怪斑纹。	Normal 40 42 褐色
他养了一只很大的斗鸡(云南出斗鸡)。	Normal 14 16 斗鸡
他想不到天下竟有这样不怕死的人,气哼哼地问:“你难道没看见你哥哥的下场吗？”	Normal 33 35 下场
梁思成第一个抓住铁索，两腿悬空地往刹尖攀援。	Hard 17 19 刹尖
他想，病人吃错了药，那多危险啊！	Normal 3 5 病人
这样我就能够拍下好几百张由反物质留在云室中的精美照片。	Hard 13 16 反物质
生动的描画，深切的体会，他觉得诗人巨大的笔触也写出了他飘零的生活。	Normal 3 5 描画
各种各样的飞禽纷纷落到河边的牛蒡草上，它们啄食牛蒡尖儿的时候，发现了爷爷的毡靴。	Normal 9 11 落到
在美国，以快捷、价廉取胜，并被大众所广泛接受的麦当劳，虽然在北京也受到了热烈的欢迎，但其中被赋予的意义与其美国祖源地却有很大的不同。	Hard 55 58 祖源地
水上那一个不再说什么，手脚并用的拍着水傍了码头。	Hard 19 20 傍
玄德屏人促席而告曰：“汉室倾颓，奸臣窃命，备不量力，欲伸大义于天下，而智术浅短，迄无所就。	Normal 16 18 奸臣
画家利用树木、船只、房屋，特别是那无尽的瓦垄的一些共同特征，重复排列，以取得几条街道（亦即画面）的统一性。	Normal 49 52 统一性
这里包含的诗人的感情，是对寒冷环境的反抗，也是对不屈的、斗争的品格的歌颂，有荷戟独彷徨的孤寂之感，也有永不停息战斗的低强精神。	Normal 31 33 品格
至于视觉经验，也都表现得很有动感：写荷花迎风则“红披绿偃，摇荡葳蕤”，写微风拂水则“细生鳞甲”，写流萤则“（幽火）班班，若骇若惊，奄忽去来”，写山则“森森欲下搏人”。	Hard 54 59 幽火）班班
这一来毡靴损坏得可厉害啦，不光是底子，就连底子往上拐弯儿的地方，全都出现了裂纹。	Hard 3 5 毡靴
只有在下雨的日子里，大家才可以痛痛快快的洗上一会澡。	Normal 3 5 下雨
它是从当地一座五千年前原始社会的墓葬中发掘出来的，考古学家称它为“中华第一龙”。	Normal 33 35 中华
他说：“作晚上仔细地想了又想，大儿子嘛，不论怎么穷吧，也是我们家的接班人哪。	Normal 7 9 仔细
莲心里含有莲心碱、荷叶碱、木犀草甙、金丝桃甙等，有强心和降血压的功效。	Hard 18 22 金丝桃甙
春天来了，它成了一只壮猫了，却仍不改它的忧郁性，也不去捉鼠，终日懒惰的伏着，吃得胖胖的。	Normal 30 32 终日
如在早春三四月间，南京桃花要比北京早开20天，但是到晚春五月初，南京刺槐开花只比北京早10天。	Normal 2 4 早春
只是它的联想的意义迷离不易捉摸，它可以联想到燃烧弹，鸦片烟榻，庙里焚香，“一川烟水”，“杨柳万条烟”，“烟光凝而暮山紫”，“蓝田日暖玉生烟”……	Hard 37 41 一川烟水
假如弄明白的话，我一伸手就会把这个对蜣螂来说沉重无比的粪蛋轻松拿起来，放到它的家里。	Hard 18 20 蜣螂
没等朱丹说完，大师便向朱丹挥挥手，果断而又惋惜地说：“你现在可以回去了。”	Normal 17 19 果断
请授权一位您所信任的人士，使他可以非正式地完成下列任务：	Normal 17 20 非正式
淘气的孩子们去听窗，学会了这两句话，就给两位神仙加了新外号：三仙姑叫“前世姻缘”，二诸葛叫“命相不对”。	Normal 31 33 仙姑
大海呜咽，寒风卷着浪花，痛悼伟人的离去……	Normal 9 11 浪花
茶水对这山旮旯的群众来说，确实新鲜。	Hard 4 7 山旮旯
武松放了手，来松树边寻那打折的棒橛，拿在手里，只怕大虫不死，把棒橛又打了一回。	Normal 23 25 只怕
例如《诗经·鲁颂》的《駉》这一首诗里提到马的名称就有16种：“驈”(身子黑而胯下白的)，“皇”(黄白相间的)，“骊”(纯黑色的)，“黄”(黄而杂红的)，“骓”(青白杂的)，“駓”(黄白杂的)，“騂”(红黄色的)，“骐”(青黑成纹像棋道的)，“驒”(青黑色而有斑像鱼鳞的)，“骆”(白马黑鬃)，“駵”(红马黑鬃)，“雒”(黑马白鬃)，“駰”(灰色有杂毛的)，“騢”(红白杂毛的)，“驔”(小腿长白毛的)，“鱼”(两眼旁边毛色白的)。	Hard 147 148 駵
当时副刊最有名的，是《申报》的《自由谈》和《新闻报》的《快活林》，都是后来被鲁迅先生称之为“鸳鸯蝴蝶派”的主要阵地，内容浅薄无聊。	Hard 46 50 鸳鸯蝴蝶
麦子是土地上最优美、最典雅、最令人动情的庄稼。	Normal 0 2 麦子
弗里德里赫国王龙颜大怒。	Normal 5 7 国王
一想到他就要离开这儿，从此再也见不到他了，我就忘记了他以前给我的处罚，忘记了他如何用戒尺打我。	Hard 42 44 戒尺
她刷洗杯盘碗碟，在那油膩的盆沿上和锅底上磨粗了她那粉嫩的手指。	Normal 1 3 刷洗
真的，灯笼的缘结得太多了，记忆的网里挤着的就都是。	Hard 6 7 缘
另外还要个拦头工人，上滩下滩时看水认容口，出事前提醒舵手躲避石头，恶浪与洑流，出事后点篙子需要准确，稳重。	Normal 28 30 躲避
远远望去，到处是一丛丛绿绿的凤尾竹和遮天盖地的油棕林。	Normal 8 11 一丛丛
小伙伴们都称赞我的冰灯,连大军也有点羡慕我。	Normal 13 15 大军
1928年10月13日，补记	Normal 7 8 月
柏杨先生于是建议，应该组织一个“借书必还大联盟”，盆中歃血，对天立誓，誓曰：“借书不还，天打雷劈。”	Hard 27 29 歃血
这真不啻是诞生了一次。	Hard 2 4 不啻
这事到现在已经隔了四年；在这四年里，我历尽艰苦，受尽了非人的虐待，我咬紧了牙，哼都不哼一声。	Normal 24 26 受尽
升旗的时候，礼炮响起来。	Normal 3 5 时候
大圣不恋战，只情跑起。	Hard 6 10 只情跑起
积成峁，堆成墚，又堆积成一大片一大片的塬。	Hard 2 3 峁
这一距今2000多年的文物珍品，从1980年开始，在欧美和日本各地展出，每天都吸引着成千上万的观众。	Normal 26 28 欧美
曙光已在窗上出现，他一点也没有觉察到。	Normal 10 12 一点
“揍死你，给大家做个榜样！”	Normal 6 8 大家
圜丘建筑上有一个特点。	Hard 0 2 圜丘
于是他用舵把对准鲨鱼的头打去，鲨鱼的两颚正卡在又粗又重的死鱼头上，不能把它咬碎。	Normal 15 17 鲨鱼
蔡林看了看老师，撇撇嘴：“老师，我是差生，没人提问我的。”	Normal 23 25 提问
在鲫鱼背前，爸爸给我和老爷爷照了一张相，留作纪念。	Normal 11 14 老爷爷
刘鹗先生在这一段里连用七八种不同的譬喻，用新鲜的文字，明了的印象，使读者从这些逼人的印象里感觉那无形象的音乐的妙处。	Hard 0 2 刘鹗
母亲生前没给我留下过什么隽永的哲言，或要我恪守的教诲，只是在她去世之后，她艰难的命运，坚忍的意志和毫不张扬的爱，随光阴流转，在我的印象中愈加鲜明深刻。	Normal 31 33 去世
鲁达坐下道：“奉着经略相公钩旨，要十斤精肉，切做臊子，不要见半点肥的在上头。”	Hard 9 15 经略相公钩旨
人们常说“开卷有益”，其实读读春联也是一种很好的学习。	Normal 11 13 其实
第一种是躺着读，这是陶渊明所标榜的好读书不求甚解，但是他自己并不一定实行的办法；而大多数文学爱好者就是这样读的，其特点是没有固定的目的，真所谓博览群书。	Normal 41 44 大多数
于是他从集上买来一小片毛毡，剪成靴掌，缝上——结果毡靴又能穿了，跟崭新的一般。	Normal 36 38 一般
有人说这蘸浆的手臂悠然摆来，悠然摆去，好赛伴着鼓点，和着琴音，每一摆刷，那长长的带浆的毛刷便在墙面“啪”的清脆一响，极是好听。	Hard 19 21 好赛
我们平时使用的光盘，就是激光存储信息的载体。	Hard 19 21 载体
同样，雌性激素水平较高的孕妇，所生的女孩食指通常短于无名指，而日后患乳腺癌的可能性也较高。	Normal 26 29 无名指
可惜它们后来都成了兵士们心头的哀音。	Normal 9 11 兵士
吓的众人一拥争去拾玉。	Normal 2 4 众人
当时三人坐下，李逵便道：“酒把大碗来筛，不奈烦小盏价吃。”	Hard 18 19 筛
原来，国王发给孩子们的花籽是煮过的，怎么可能发芽、开花呢？	Normal 22 24 发芽
朋友说：那本来的生活历程就是这样。	Normal 5 7 本来
梁艳年轻，眼疾手快，给球的速度要跟得上……	Normal 2 4 年轻
我坐在一个美国伞兵身边，他是第101空降师——巴顿英雄部队的，约摸二十岁。	Normal 9 11 身边
李达把渡河进展情况汇报完后，刘伯承一直在沉思。	Normal 5 7 进展
于是，在居维叶死后，为了科学的利益，出于好奇的需要，他的同事们决定打开这颗最伟大的头颅。	Normal 20 22 好奇
一边扭着秧歌，女同志们又齐声唱起歌来：	Normal 12 14 齐声
他们纳粮当兵，敬畏官吏，何负于晋？	Hard 12 16 何负于晋
此时此刻，德拉的秀发泼撒在她的周围，微波起伏，闪耀光芒，有如那褐色的瀑布。	Normal 31 33 褐色
极天云一线异色，须臾成五采。	Hard 5 7 异色
只有那些非常接近临界密度的能存活得足够久并包含足够形成恒星和行星的物质。	Normal 27 29 恒星
高尔基的儿子只有10岁，还没有镢头那么高。	Hard 15 17 镢头
杨长雄面白手颤，忍无可忍。	Normal 0 2 杨长
他靠着活命的只是一辆破旧的三轮车；有个哥哥死了，有两个侄儿“没出息”，此外就没什么亲人。	Normal 3 5 活命
李逵也不答应他，便就地下掳了银子，又抢了别人赌的十来两银子，都搂在布衫兜里，睁起双眼说道：“老爷闲常赌直，今日权且不直一遍。”	Hard 57 59 不直
即使荒野露宿，栖身洞穴，也要“燃松拾穗，走笔为记”。	Hard 15 19 燃松拾穗
闰土说着，又叫水生上来打拱，那孩子害羞，紧紧的只贴在他背后。	Normal 17 19 害羞
小蜘蛛用闪闪发亮的丝将自己悬挂在空中，有时候它们远离原来的楽穴，到几公里之外搭建新家，有时候它们就直接在遇到的第一根树枝上安家。	Hard 29 31 楽穴
在夜雨中与家人围炉闲谈，几乎都不会拌嘴；在夜雨中专心攻读，身心会超常地熨帖；在夜雨中思念友人，会思念到立即寻笔写信；在夜雨中挑灯作文，文字也会变得滋润蕴藉。	Hard 75 77 蕴藉
我们分析了当时的情况：水流湍急，即便先头分队能强渡过去，竹排来回渡一次，也需要一个钟头的时间，而敌人又在拼命地封锁。	Normal 52 54 拼命
人们在河边涮洗着衣服和新摘下来的青菜；每当傍晚时分，酷爱清洁的女人们就会来到河里洗澡，平日里穿的五颜六色的筒裙，这时变成了一个个色彩斑斓的“浴罩”浮在水面上，她们有时还在水中嬉戏，在夕阳的映衬下，更显出几分妩媚。	Normal 91 93 夕阳
屠格涅夫仰坐在一个沙发上，用一种轻轻并有点犹豫的声调慢慢地讲着;但是不管什么事情一经他的嘴讲出，就都带上非凡的魅力和极大的趣味。	Normal 61 63 趣味
急下马向前施礼，问曰：“先生非卧龙否？”	Hard 14 18 非卧龙否
我仰望高处，蔚蓝色的晴空衬托着片片白云，白云下边，在令人目眩的高空中，几只燕子愉快地来回穿飞，好像要用它们的小剪刀似的尖翅膀划破长空。	Normal 64 66 长空
眼看前面就是赫尔辛娜森林了，奥斯卡振翅向前。	Normal 14 17 奥斯卡
这时的旅鼠不再胆小怕事，见人就跑，而是恰恰相反，在任何天敌面前它们都显得勇敢异常，无所畏惧，具有明显的挑衅性，有时甚至会主动进攻，真有点天不怕地不怕的样子。	Hard 3 5 旅鼠
因为大人们对数字情有独钟。	Normal 6 8 数字
四乡的外出谋生者，都把自己的血汗和眼泪，堆在他的肩上。	Normal 14 16 血汗
我常为现在我院中的那两只大呆鸟感到难过，它们似乎已经没有了日升飞出日落飞回的习惯，大白天都蹲在城里无所事事，而且也不敢肆无忌惮地大叫，老鸹不老呱了，怪可怜的。	Hard 67 72 老鸹不老呱
淘气的孩子们去听窗，学会了这两句话，就给两位神仙加了新外号：三仙姑叫“前世姻缘”，二诸葛叫“命相不对”。	Hard 7 9 听窗
那是下午，我到镇的东头访过一个朋友，走出来，就在河边遇见她；而且见她瞪着的眼睛的视线，就知道明明是向我走来的。	Normal 9 11 东头
如果我们把这种具象化的旅行，抽象化为人生的旅途，我们不分彼此，都是苦旅者。	Hard 33 36 苦旅者
疑问是这样的：刚刚从人工孵卵器孵出的小雁鹅，总是把第一个碰到的生物认作是自己的母亲，并且一心一意地跟随着她；但是水鸭子就不同了，凡是由人工孵卵器养出的小凫，总是极其羞怯，难以接近，每次一出壳，就赶紧逃开，躲到附近的暗角里不肯出来。	Hard 19 21 雁鹅
或许就从一个叶柄眼里长上来，凋落的曾经那么悠悠地欢乐过，欢乐的也将要寂寂地凋落去。	Normal 0 2 或许
先生拿着戒尺，走到孙中山跟前，厉声问道:“你会背了？”	Hard 4 6 戒尺
随着祖国社会主义建设事业的发展，1974年又建成了黄河上唯一的单孔铁路桥和宽十米、长一百四十米、钢筋混凝土结构的悬索公路吊桥。	Hard 50 53 混凝土
对那些失去亲人的父亲、母亲、丈夫和妻子们，对那些兄弟、姐妹，尤其是孩子们，在你们悲痛哀悼的日子里，所有的美国人都和你们紧紧地站在一起。	Normal 27 29 姐妹
血和惨叫使整个工房的人都怔住了，大家都在发抖，这好像真是一个榜样。	Normal 24 26 好像
为了解决这个难题，科学家把淋浴室做成了一个密封浴桶，或是一个密封浴罩，在淋浴室下边安装吸管，它可以把喷出来的水朝一个方向吸。	Normal 43 45 吸管
大熊猫如今分布地域十分狭窄，仅见于我国四川省的岷山、邛崃山和大小凉山，甘肃省的南缘和陕西省秦岭南麓等海拔2000～3500米的崇山峻岭。	Normal 15 17 见于
至如梁、柱、枋、標、门、窗、墙、瓦、植、阶、栏杆、隔扇、斗拱、正脊、垂脊、正吻、戗兽、正房、厢房、游廊、庭院、夹道等等。	Hard 40 42 戗兽
居然有勇气不挪窝儿。	Normal 0 2 居然
两个新年虽照例可以看到军营里和各乡来的狮子龙灯，在小教场迎春，锣鼓喧阗大热闹，到了十五夜晚，城中舞龙耍狮子的镇筸兵士，还各自赤裸着肩膊，往各处去欢迎炮仗烟火。	Hard 54 56 镇筸
你的心怦怦直跳，惟恐意外发生。	Normal 12 14 发生
“很简单，”怀特森老师眼里闪过狡黠的光芒，解释道，“有关凯蒂旺普斯的一切都是我编造的，这种动物从来就没有过。	Hard 15 17 狡黠
车窗外是茫茫的大戈壁，没有山，没有水，也没有人烟。	Hard 8 10 戈壁
如果孕妇怀孕期间睾丸素水平较高，生下的孩子就更容易成为左撇子，也更容易在日后得心脏疾病和孤僻症。	Hard 8 11 睾丸素
还有画眉啦，黄莺啦，百灵啦……	Normal 2 4 画眉
麦苗在霜冻里返青了，山桃在积雪里鼓苞了。	Normal 10 12 山桃
窃国大盗袁世凯称帝，章太炎曾拟模仿明朝的方孝孺故事，身穿麻衣、手执方杖、痛哭于国门，以此哀悼共和的灭亡。	Hard 39 41 国门
我承认就是东山樵夫也有些微的创造作用——为泰山剃头理发，只是我们希望不要把我们的鼻子或眉毛剃掉。	Normal 40 42 鼻子
突然，一只幼龟率先把头探出巢穴，却又欲出而止，似乎在侦察外面是否安全。	Normal 28 30 外面
哪里要开山，哪里要架桥，哪里要把陡坡铲平，哪里要经常勉励工作人员，说：“我们的工作首先要精密，不能有一点儿马虎。	Normal 50 53 一点儿
说不见又出现了一个，老远喊我：“都到这地方了，不到处转一转，多吃亏呀！”	Normal 1 3 不见
一起一伏地载送着逍遥自在的鹅和鸭；远处有一座半掩着柳树的磨坊轧轧地响着，鸽子在它的上空迅速地盘着圈子，在明亮的空气中斑斑驳驳地闪耀着……	Normal 17 19 远处
他理直气壮地说：“这都是报上明明白白叠载出来的。”	Hard 18 20 叠载
江理以“从者七人，二僧与俱”，组成一支浩浩荡荡的登山队，“一仆前持斧斤，剪伐丛莽，一仆鸣金继之，二三人肩糗执剑戟以随。”	Hard 48 58 二三人肩糗执剑戟以随
毛泽东：“在你们当中还有大戏剧家李伯钊、危拱之等同志嘛，我提议：请伯钊同志给大家跳苏联红军舞好不好？”	Normal 46 49 好不好
提了一条齐眉短棒，奔出南门，一道烟走了。	Hard 14 17 一道烟
当多数缺少天赋的人将自己的阅读能力很快就只用来读报上的新闻或商业版时，少数人仍然迷恋于字母和文字的特殊魅力（因为它们古时候都曾经是富有魔力的符箓和咒语）。	Hard 70 72 符箓
然后我建造了一个云室，在云室中可以看到亚原子粒子留下的踪迹。	Hard 19 24 亚原子粒子
“青海长云暗雪山，孤城遥望玉门关。	Hard 9 16 孤城遥望玉门关
正如次日报载，皇上当时御体不适。	Hard 11 13 御体
于是，她便机智地与逢蒙周旋。	Hard 9 11 逢蒙
这才有了千古名句“鸟宿池边树，僧敲月下门。”	Hard 9 11 鸟宿
故事、图形具有极大的包容性，有关自然的、社会的，人类自身生活的，或是物质世界或是精神世界，无所不有，故能给学生丰富的想象空间，充分调动学生的思维，激发学生的想像力、创造力，在学生口述自己想像成果的同时，还能锻炼语言表达能力，也为学生写作打下一定基础。	Normal 78 81 想像力
托尔斯泰面部的其他部件胡子、眉毛、头发，都不过是用以包装、保护这对闪光的珠宝的甲壳而已，这对珠宝有魔力，有磁性，可以把人世间的物质吸进去，然后向我们这个时代放射出精确无误的频波。	Hard 86 88 频波
我只是微微一笑，依旧写东西。	Normal 1 3 只是
哈哈，异想天开！	Normal 0 2 哈哈
入了神，自然乐在其中。	Normal 4 6 自然
打开信封一看，里面是7美元和一张便条，上面写着：我为你骄傲。	Normal 27 29 骄傲
那笼子里的黑老鸹子，长出凤头儿来，也会说话呢！	Hard 5 9 黑老鸹子
星系们会继续以恒常速度相互离开。	Hard 7 9 恒常
那棵树有一种端庄的王者风度，两人合抱粗的树干呈深黑色，树枝如巨大的龙爪，遒劲而伸展，缀满了繁密的树叶，即使在深冬也依然葱郁。	Hard 36 38 遒劲
我眺望四周，一片茫无边际的蔚蓝的海，无数波浪闪耀着金鳞；头上，也是这样茫无边际，这样蔚蓝的海——在那儿，温柔的太阳在运行着，宛然在微笑。	Normal 65 67 微笑
我们全体担架队员给你挂匾……	Hard 10 12 挂匾
芽苞初放。	Normal 2 4 初放
一开始他就把我撩下几丈远。	Normal 1 3 开始
糟糕的是，在天敌的保护作用消失以前，我们总是对其知之甚少。	Normal 13 15 消失
无论何种姿态，都显示出顽强的万古长青的生命力，不怕长年的风吹雨打，冰雪欺压，屹立于悬岩危石之上，昂首苍穹。	Normal 19 22 生命力
不过母亲猜到我们会回来得晚，于是她把开饭的时间推迟了，热腾腾的饭菜给我们准备着。	Normal 18 20 开饭
这种苦痛却比不得普通的贫、病、老，可以达观排解得开。	Hard 19 23 达观排解
我们那里上学的岁数是多拣单数的，所以这使我记住我其时是七岁。	Hard 11 12 拣
多少年来，每到春天，我总要挑个风和日丽的日子，带上孩子们到郊区的野地里去挖荠菜。	Normal 7 9 春天
火是一部无始无终，百读不厌的书，你哪回看到两个形状相同的火焰呢！	Normal 23 25 形状
屠格涅夫也常常带来一些外文书籍，并非常流利地翻译一些歌德和普希金的诗句。	Hard 29 32 普希金
他把旱烟锅子朝鞋底上磕着：“娃呀，你太小哩。”	Normal 7 9 鞋底
如果在人身上做，成功率可能更低，而且很可能会产生出许多畸形的、具有严重缺陷的克隆人。	Normal 22 24 产生
州平曰：“山野之夫，不足与论天下事，适承明问，故妄言之。”	Hard 10 17 不足与论天下事
他嚼了一嚼，觉得肉很好，味道也香，象牲口的肉，又紧凑又有水分，可就是颜色不红。	Normal 28 30 水分
凤姐冷笑道：“你们要拣远道儿走么！	Normal 2 4 冷笑
它没有婆娑的姿态，没有屈曲盘旋的虬枝。	Hard 16 18 虬枝
他说：“我会水，水刚到嘴边，蹚过来的。”	Normal 11 13 嘴边
那做工的女人可看见了；她提起一把扫帚来在我的颈脊上死命地打了一下。	Normal 12 14 提起
我的思念越过蜿蜒曲折的小溪，升到高高的冈峦上，在塔亭般的瞭望楼里，我要同你一起倚窗外望……	Normal 11 13 小溪
虽然今天的自然力量与冰河期时不同，但它还在那儿：一个复杂、精密、完整的系统，各种生命相互联系。	Normal 21 23 那儿
悲哀的呼号没打动天神、龙神、山神、树神的心，河水流得更急，波涛翻得更凶，好几次要把那人从木头上冲下来。	Normal 8 10 天神
司机说，你们的运气不错呵，戈壁滩上的旋风、海市、彩虹、丝路花雨，都看见了。	Hard 27 31 丝路花雨
酒保唱了喏，认得是鲁提辖，便道：“提辖官人，打多少酒？”	Hard 17 21 提辖官人
例如《诗经·鲁颂》的《駉》这一首诗里提到马的名称就有16种：“驈”(身子黑而胯下白的)，“皇”(黄白相间的)，“骊”(纯黑色的)，“黄”(黄而杂红的)，“骓”(青白杂的)，“駓”(黄白杂的)，“騂”(红黄色的)，“骐”(青黑成纹像棋道的)，“驒”(青黑色而有斑像鱼鳞的)，“骆”(白马黑鬃)，“駵”(红马黑鬃)，“雒”(黑马白鬃)，“駰”(灰色有杂毛的)，“騢”(红白杂毛的)，“驔”(小腿长白毛的)，“鱼”(两眼旁边毛色白的)。	Hard 190 191 驔
20世纪60年代的一天，周恩来总理在中南海勤政厅招待外宾，客人对中国菜肴风味之独特、味道之鲜美大为赞赏。	Normal 42 44 味道
再还有‘日落江湖白，潮来天地青’：这‘白’‘青’两个字也似无理。	Hard 4 9 日落江湖白
那个满脸横肉的便衣侦探指着父亲问阎振三：“你认识他吗？”	Hard 16 19 阎振三
威尼斯的小艇有二三十英尺长，又窄又深，有点儿像独大舟。	Normal 4 6 小艇
洞内岔路横生，如同迷宫一样。	Normal 9 11 迷宫
肚子里先有了这三个人作了底子，然后再把陶渊明、应玚，谢、阮、庾、鲍等人的一看。	Hard 23 25 应玚
圜丘建筑上有一个特点。	Normal 8 10 特点
在熹微的晨光里，他看见不远处有一栋小小的、红色屋顶的农家。	Hard 1 3 熹微
次日早起五更，在府里把担仗都摆在厅前，老都管和两个虞候又将一小担财帛，共十一担，拣了十一个壮健的厢禁军，都做脚夫打扮。	Hard 25 27 虞候
这样，如果暴涨理论是正确的，宇宙就应包含足够的暗物质，使得密度达到临界值。	Hard 5 7 暴涨
但是，这世界上还有别的东西，别的东西延伸得很快，柏油一里一里铺过来，高压线一千码一千码架过来，公寓楼房一排一排挨过来。	Normal 24 26 柏油
劳动，这是作家义无反顾的唯一选择。	Normal 12 14 唯一
其时进来的是一个黑瘦的老师，八字须，戴着眼镜，挟着一迭大大小小的书。	Hard 25 27 一迭
我们聆听着訇然作响的瀑声，只觉得自己的胸臆在扩展，似张开的山谷，那瀑布便直跃而进，挟来大自然生生不息的活力，回荡着大自然纯正清脆的音响。	Hard 5 9 訇然作响
上午11点钟左右，全茶峒人就吃了午饭。	Hard 10 12 茶峒
二十六个春秋过去，象鞍已经破旧了，仍显出凝重华贵；嘎羧披挂上象鞍，平添了一股英武豪迈的气概。	Hard 25 27 嘎羧
如果你和一个陌生人握手，凭感觉你就能知道对方是从事体力劳动，还是从事脑力劳动，因为前者的手粗糙有力，后者的手柔软细腻。	Normal 6 9 陌生人
家乡有一句“紧走搭石慢过桥”的俗语。	Hard 6 8 紧走
京口瓜洲一水间，钟山只隔数重山。	Hard 2 7 瓜洲一水间
在这以前，爱因斯坦决心关起门来搞统一场论。	Hard 18 20 场论
而既要以过去的经验为依据，我倒希望知道，十年来英国政府的所作所为中，有哪一点足以证明先生们用以欣然安慰自己几个为代表的和平希望呢？	Normal 45 47 用以
今诸君苟不于此时植其基，勤其学，则将来万一因生计所迫，出而仕事，但任讲席，则必贻误学生；置身政界，则必贻误国家。	Hard 39 41 贻误
收集那些难以逐一熟记的行为举止的“道德箴言”，是不是一件轻而易举的事情呢？	Hard 19 21 箴言
灯塔微笑地回答道：“因为我做着对人们有益的事，心里踏实得很！”	Normal 2 4 微笑
至如梁、柱、枋、標、门、窗、墙、瓦、植、阶、栏杆、隔扇、斗拱、正脊、垂脊、正吻、戗兽、正房、厢房、游廊、庭院、夹道等等。	Normal 49 51 游廊
南方来的人觉着这个“脖子”有名无实，冬天刚过去，夏天就来到眼前了。	Normal 5 7 觉着
彝家有一句谚语：过年是嘴巴的节日，火把节是眼睛的节日。	Hard 0 2 彝家
他们弯着腰，流着汗，喊着号子，船却走得很慢。	Normal 0 2 他们
至于视觉经验，也都表现得很有动感：写荷花迎风则“红披绿偃，摇荡葳蕤”，写微风拂水则“细生鳞甲”，写流萤则“（幽火）班班，若骇若惊，奄忽去来”，写山则“森森欲下搏人”。	Hard 24 28 红披绿偃
玄德屏人促席而告曰：“汉室倾颓，奸臣窃命，备不量力，欲伸大义于天下，而智术浅短，迄无所就。	Hard 4 6 促席
一天黄昏，北风呼呼地怒号着，天色十分阴暗。	Normal 14 16 天色
他捧给玛丽一卷用三色丝带扎好的羊皮纸文件，把用绸带悬着的金钥匙挂在她的脖子上，这就是那个装着一克镭的铅匣子的钥匙。	Hard 48 49 镭
后来各人走的路不同，志也不同。	Normal 0 2 后来
遇到挫折和失败依然乐观，即使不高兴，也不拉长了脸唉声叹气的人。	Normal 9 11 乐观
什么时候他才在绞刑架上做怪笑呢？	Normal 2 4 时候
由于草木足够作它们的食粮，由于它们有充分的东西来满足它们的食欲，又由于它们对动物的肉毫无兴趣，所以它们绝不对其他动物作战，也绝不互相作战，也不互相争夺生存资料。	Hard 77 79 资料
就这样，鷸和蚌相持着，谁也不让谁。	Hard 6 7 蚌
当然，由于愚蠢，由于年轻，更多的是由于无知也犯了不少错误。	Normal 19 21 无知
当然也有人为了谦虚，把自己的发言、提意见、提建议甚至演说称为“汇报一下”。	Normal 28 30 称为
让我担心的是，家里并不宽裕，我只攒了一百美元，却要由五个孩子来分享，他们怎么可能买到很多很好的礼物呢？	Normal 31 33 分享
因向几个同案商议，瞒着丈人，到城里乡试。	Hard 4 8 同案商议
一天傍晚，袅袅炊烟笼罩着村庄，远处传来一阵悦耳的吉他声。	Normal 21 23 悦耳
由此可见，用螫针重复刺三次，真是再符合逻辑不过的了。	Hard 6 8 螫针
武松放了手，来松树边寻那打折的棒橛，拿在手里，只怕大虫不死，把棒橛又打了一回。	Hard 15 17 棒橛
自然是江南日暮的雪景；“寒沙梅影路，微雪酒香村”，则雪月梅的冬宵三友，会合在一道，在调戏酒姑娘了；“柴门闻犬吠，风雪夜归人”，是江南雪夜更深人静后的景况；“前村深雪里，昨夜一枝开”，又到了第二天的早晨，和狗一样喜欢弄雪的村童来报告村景了。	Hard 18 23 微雪酒香村
杀好了腰，再穿上肥腿的白裤，裤脚用鸡肠子带儿系住，露出那对"出号"的大脚！	Hard 17 20 鸡肠子
以前看见包弟作揖，我就想笑，这些天我在机关学习后回家，包弟向我作揖讨东西吃，我却暗暗地流泪。	Hard 6 8 作揖
这样，钱老才又在科技委干了五年。	Hard 8 11 科技委
许多年前旅游业还没有开展，园子荒芜冷落得如同一片野地，很少被人记起。	Normal 24 26 野地
至于公和私的关系，人和己的关系，应以人为先，正如孔子所说：“君子贵人而残己，先人而后己。”	Hard 38 43 先人而后己
站在这里，长城站全貌尽收眼底，她为找到这个最佳角度而高兴。	Normal 8 10 全貌
我们说《雪》是寓意深邃的撒文诗，就是说它并非如有的研究者所说的那样，仅仅是一篇“绝好的眷念故乡，回忆儿时的抒情小品文”，在故乡的自然景色的描绘中流露了“鲁迅心灵”里一种“深刻的恬适的回味”。	Normal 55 58 小品文
两个虞候口里不言，肚中寻思：“这厮不值得便骂人！”	Hard 15 17 这厮
可是，在自然看来，人类上下翻飞的这片巨大空间，不过是咫尺之间而已，就如同鲲鹏看待斥鴳一般，只是蓬蒿之间罢了。	Hard 40 42 斥鴳
这个计划建立的“工作框架图”所提供的序列，经生物信息的加工与其他技术的研究，已鉴定了近4万个基因，而且已经克隆了几十种与疾病直接有关的“疾病等位基因”。	Hard 68 74 疾病等位基因
天保恰好在那天应向上行，随了陆路商人过川东龙潭送节货，故参加的就只傩送。	Hard 33 35 傩送
在浩茫无际的大千世界上，在林林总总的植物中，燕园的这一棵古藤，实在渺小得不能再渺小了。	Normal 18 20 植物
我想拉开她，我想推开这沉重的氛围，我想看见他坐起来，看见他羞涩的笑。	Normal 8 10 推开
有几个女人拗不过孩子的欲望，便给他们买了最便宜的小洋囝囝。	Hard 26 28 囝囝
我回到堂前，看见中堂挂着的立轴──吴昌硕描的墨竹，似觉更有意味。	Hard 13 15 立轴
杨志道：“你也没分晓了，如何使得！	Normal 12 14 如何
我一直研究科学文献，最后我确信能够建造一台所谓的电子感应加速器，这种加速器能把电子加速到数百万电子伏特（100万电子伏特是指电子在100万伏特的电场中被加速后所获得的能量）。	Normal 13 15 确信
他对小山羊说：“刚才在路上遇见了小刺猬，我们聊了一会儿，耽误了一点儿时间，咱们吃了午饭再去吧。”	Normal 17 19 刺猬
王安石做官时实行变法改革，历经磨难。	Normal 3 5 做官
我在家乡看到的白兰多是一人高，昆明的缅桂是大树！	Normal 21 23 大树
又有夜岚数层斗起，如鱼肚白，穿入出炉银红中，金光煜煜不定。	Hard 2 4 夜岚
她顿时热泪满面。	Normal 1 3 顿时
鼹鼠先生来到松鼠太太门前。	Hard 0 2 鼹鼠
忽见一人，容貌轩昂，丰姿俊爽，头戴逍遥巾，身穿皂布袍，杖藜从山僻小路而来。	Hard 17 20 逍遥巾
何满子被爷爷拴在葡萄架的立柱上，系的是拴贼扣儿。	Hard 0 3 何满子
然后他对所有的参议员说：“对参议院里的任何人都一样，如果你们穿的那双鞋是我父亲做的，而它们需要修理或改善，我一定尽可能地帮忙。	Normal 60 62 帮忙
回来的路程危险增加了十倍，在前往极点的途中只要遵循罗盘的指引，而现在他们还必须顺着自己原来的足迹走去，在几个星期的行程中必须小心翼翼，绝对不能偏离自己原来的脚印，以免错过事先设置的贮藏点——在那里储存着他们的食物、衣服和凝聚着热量的几加仑煤油。	Normal 71 73 偏离
周旋了许久，东郭先生伯天黑了，野独越来越多，就对狼说：“民间风俗，凡事先问三老，如果三老说行，我没话说，如果反对，你说算了。”	Hard 15 17 野独
有时候，他引诱你到语言文字的穷边涯际，下面是深秘的静默：“此中有真意，欲辨已忘言。”	Hard 35 40 欲辨已忘言
不用说，这首诗至今能背得滚瓜烂熟。	Normal 7 9 至今
它没有婆娑的姿态，没有屈曲盘旋的虬枝，也许你要说它不美。	Hard 3 5 婆娑
这时船慢了，不久就到，果然近不得台旁，大家只能下了篙，比那正对戏台的神棚还要远。	Hard 25 26 篙
积成峁，堆成墚，又堆积成一大片一大片的塬。	Hard 6 7 墚
考察队员在朱鹮的巢边搭起了窝棚,忍受着风吹雨打、日晒虫叮,精心地观察,守护着这几只朱鹮。	Hard 5 7 朱鹮
就这样，鷸和蚌相持着，谁也不让谁。	Hard 4 5 鷸
母亲叫我和小帮工把曲一粒粒拣出来，不然就会愈来愈多的。	Hard 9 10 曲
只听一声巨响，“诺曼底”号的船身一下被剖开了一个大口子。	Normal 14 16 船身
在野蛮的军国主义协助下的极权姿态，给了它们致命一击。	Normal 8 10 协助
范进即将这银子交与浑家打开看，一封一封雪白的细丝锭子，即便包了两锭，叫胡屠户进来，递与他道："方才费老爹的心，拿了五千钱来。	Hard 24 26 锭子
晚饭摆出来了，四叔俨然的陪着。	Normal 0 2 晚饭
当人类的胚胎成长到5周左右时，手就出现了，但非常小，如同鱼的鳍一般。	Hard 30 31 鳍
倘许给本村人，财礼就不多；唯独肯嫁进深山野坳里去的女人少，所以她就到手了八十千。	Normal 13 15 唯独
潮湿的下雨天，是打麻线的好天气，麻线软而不会断。	Normal 16 18 麻线
明屠本畯有一首诗，叙述煎荔枝的方法，说“旋沉荔花蜂酿蜜，清香不减蔗浆寒”，大概是关于荔枝蜜最早的记载。	Hard 20 27 旋沉荔花蜂酿蜜
酒保唱了喏，认得是鲁提辖，便道：“提辖官人，打多少酒？”	Hard 4 5 喏
因为知用中学的先生们希望我来演讲回，所以今天到这里和诸君相见。	Normal 28 30 相见
恰巧在这时候彰德府来了一伙难民，其中有个老李带来个八九岁的小姑娘，因为没有吃的，愿意把姑娘送给人家逃个活命。	Normal 51 53 活命
大约潭是很深的、故能蕴蓄着这样奇异的绿；仿佛蔚蓝的天融了一块在里面似的，这才这般的鲜润呀。——	Normal 38 40 这般
过了葭芦河就有了回旋余地。	Normal 5 6 就
四叔家里这回须雇男短工，还是忙不过来，另叫柳妈做帮手，杀鸡，宰鹅；然而柳妈是善女人，吃素，不杀生的，只肯洗器皿。	Hard 53 55 器皿
起先，帕霍姆走得不慌不忙。	Normal 0 2 起先
他小心翼翼地把钱全装进裤子口袋里，准备下午去玩具店买战斗机。	Normal 22 25 玩具店
世界被黄沙折腾得烦躁不安。	Normal 0 2 世界
孩子们听到可怕的训斥，纷纷逃窜。	Normal 8 10 训斥
每天，小朋友们拍着长队，等着跟它们合影留念。	Normal 3 6 小朋友
这却不然，责任是要解除了才没有，并不是卸了就没有。	Hard 2 4 不然
由于受潮水的顶托，还有一部分泥沙回淤在入海口，形成了坚硬的河岗。	Normal 3 5 潮水
我把脸伏在母亲的胸前，委屈地抽噎着。	Hard 14 16 抽噎
那天下午，海滨酒店里来了一群旅行家，其中一个女人在望着海水的时候，从一堆空啤酒罐和死了的小梭鱼中间看见了一根又粗又长的雪白的脊骨，最后面有一条庞大无比的尾巴。	Normal 59 61 雪白
象这样的冬天，乡下人叫作旱冬，对于麦的收成或者好些，但是人口却要受到损伤；旱得久了，白喉，流行性感冒等疾病自然容易上身，可是想恣意享受江南的冬景的人，在这一种冬天，倒只会得到快活一点，因为晴和的日子多了，去郊外去闲步逍遥的机会自然也多。	Hard 42 44 白喉
田间与灌木篱下，横陈着田凫、椋鸟、画眉等数不清的腐鸟的血衣，鸟儿的肉已被隐秘的老饕吃净了。	Hard 11 13 田凫
他们将自己的手掌按在石头上，然后往上喷赭色或者黑色的粉末。	Hard 19 21 赭色
那开车的还骂那民工不懂城里的规矩……	Normal 1 3 开车
酒家看了道:“有余，还有些贴钱与你。”	Hard 13 15 贴钱
曾子还说哩：“任重而道远”，“死而后已，不亦远乎！”	Hard 15 19 死而后已
不少君主重视求谏，尧设诽谤之木，舜悬招谏之鼓；封建时设立谏诤机构，付薪水养了一批谏议大夫、拾遣、补阙、正言之类的官员专挑皇帝的毛病，都是对批评稀缺的补救措施。	Normal 26 28 设立
我看她头上已硬挠挠的挽了髻，便大嫂长大嫂短的向她道歉，说刚才这个同志来，说话不好别见怪等等。	Hard 6 9 硬挠挠
一个人呷了一口酒，幽幽地提出疑问。	Hard 3 4 呷
他虽然孤零零的一个人，却没有迷路。	Normal 14 16 迷路
有诗为证:“丹崖夹石柱，菌萏金芙蓉”。	Hard 12 14 菌萏
那些属于所谓同属的生物都是另一个并且一般是已经绝灭的物种的直系后代，这与任何一个物种的公认的变种是该物种的后代，是同样的情形。	Hard 46 48 变种
但是我愿意以危机时刻讨论无用之学的执著和从容，达到与同学们在精神和意志上的相互砥砺。	Normal 8 10 时刻
是的，这好像是废话，卑之无甚高论。	Hard 12 16 无甚高论
他不怕任何艰难困苦，他富于弹性，倒下去立刻跳起来，碰伤了舐干血迹，若无其事，他以牺牲自我的意志征服一切。	Hard 28 29 舐
我决定委屈儿子，因为我伴同他的时日还长，我伴同母亲的时日已短。	Normal 11 13 伴同
地下两溜十六张楠木交椅，又有一副对联，乃乌木联牌，镶着錾银的字迹，道是：	Hard 2 4 两溜
你是个烂忠厚没用的人，所以这些话我不得不教导你，免得惹人笑话。"	Hard 3 6 烂忠厚
举人的太太，我管她叫奶奶，她很喜欢我。	Hard 0 2 举人
此游不仅自己饱饫一时眼福，还可以终久地向许多朋友夸耀呢。	Hard 6 8 饱饫
医生走了以后，休易到画室里哭了一场，把一条日本餐巾全哭温了。	Normal 23 25 餐巾
今文若何为美，若何为不美，若何则适于口而顺于耳，若何则仅供目治，违于口耳，倘能举例而申明之，归纳为若干条，诚如流行语所称大有现实意义。	Hard 29 31 目治
你捧出一面明镜，是要我重新梳妆吗？	Normal 3 5 一面
到滑铁卢车站给一位去伏克斯豪尔的朋友送行，那该是件十分容易的事，但我们从来不会被请去表演这种小技。	Normal 18 20 送行
莲心里含有莲心碱、荷叶碱、木犀草甙、金丝桃甙等，有强心和降血压的功效。	Hard 13 17 木犀草甙
它从石洞里流出来，又一滴一滴渗进石缝里去，把石块碾成的粉末变成了泥土。	Normal 22 24 石块
炒牛肝菌须多放蒜，否则容易使人晕倒。	Normal 15 17 晕倒
李小二道：“官人请甚客？”	Hard 6 8 官人
大老望着弄渡船的老船夫涎皮的老脸，轻轻地说：	Hard 11 13 涎皮
像猫那样白天和黑夜都活跃的动物，瞳孔的大小调节自如，眼睛昼夜都好用。	Normal 7 9 黑夜
宫顶建筑摒弃了巴罗克的圆顶和法国传统的尖顶建筑风格，采用了平顶形式，显得端正而雄浑。	Hard 39 41 雄浑
那男人虎虎地在起得慢一点的“猪猡”身上踢了几脚，回转身来站在不满二尺阔的楼梯上面，向着楼上的另一群生物呼喊：	Hard 14 16 猪猡
我们都看着那杯酒，果真里边就浮起一个小小的月亮的满圆。	Normal 11 13 里边
前日我出城去，碰见了你们三房里的老四，坐着好体面车，又带着四五辆车，有四五十和尚道士儿，往家庙去了。	Hard 22 24 体面
有时，为了驳倒他的一个貌似正确的“论点”，我们常常会在课后花好几个小时甚至几天的时间去思考和论证。	Normal 11 13 貌似
人家又用许多皮条把他绑在轮盘上，他听任人家捆绑，只不过时时粗声地喘气，就象一条牛垂头耷脑地给绑在屠夫的车沿上。	Normal 32 34 喘气
许多人没有烟瘾，抽了烟也不觉得什么特别的舒服，却很喜欢抽烟，违了父母兄弟的劝告，常常抽烟，就是身上只剩一角小洋了，还要拿去买一盒烟抽，他们大概也是因为爱同火接近的缘故吧！	Normal 42 44 抽烟
有一次，他回头看见病狼正饿得发慌地舐着他的血渍、他不由得清清楚楚地看出了自己可能遭到的结局——除非——除非他干掉这只狼。	Normal 14 16 发慌
1987年3月上旬，我随电影摄制组再一次接近各拉丹冬，在它的脚下安营扎寨。	Normal 30 32 脚下
雪还铺在地上，又潮湿，又荒凉；一阵刺骨的寒风吹起他的大衣的衣襟，在他的耳朵里凄惨地号叫着。	Normal 35 37 耳朵
在宇宙中，一定存在着远比我们的智慧要高得多的生物。	Normal 22 24 生物
我曾读到一个警句，是“愿你生命中有够多的云翳，来造成一个美丽的黄昏”。	Normal 31 33 黄昏
一位中国诗人说：“言有尽而意无穷。”	Hard 9 16 言有尽而意无穷
极目处，四野八荒，惟有黄色，尽是黄色。	Hard 0 2 极目
最后只剩下了树，在忠心耿耿地守护着这一方水土；只剩下了树，在小心翼翼地维持着这座城池的性格；只剩下了树，用汁液和绿荫在滋润着这城市中芸芸众生干涸的心灵。	Normal 3 5 剩下
比较早的有葡萄、苜蓿、茉莉、苹果、菠菜等等，近代的像咖啡、可可、柠檬、雪茄、巧克力、冰淇淋、白兰地、啤酒、卡片、沙发、扑克、哔叽、尼龙、法兰绒、道林纸、芭蕾舞等等，都是极常见的。	Hard 8 10 苜蓿
正在呻吟惨叫的产妇听到他的马脖上的銮铃的声音，立刻就安定了一些。	Hard 17 19 銮铃
白头鸟在林边的鸣叫声不断传来，锯木厂的后面，黎贝尔草地上，普鲁士军队正在操练。	Normal 19 21 后面
“人们为了除草，在野草上喷了很多农药。	Normal 9 11 野草
更复射，终不能入石矣。	Hard 0 3 更复射
杀死牛虻，真是不堪设想的恐怖，他感人肺腑的勇气，曾像太阳的光芒一样在他们死气沉沉的生活中闪耀，而现在，他必须死，死于他们之手，这对他们来说，就是去熄灭天上的明灯。	Hard 2 4 牛虻
雪还铺在地上，又潮湿，又荒凉；一阵刺骨的寒风吹起他的大衣的衣襟，在他的耳朵里凄惨地号叫着。	Normal 12 14 荒凉
老余打着电筒走过去，发现门是从外扣着的。	Normal 4 6 电筒
然后又重新兴奋地汇合到一起，终于明白：对水来说没有不同的道路，所有道路早晚都一定会把它带到大洋。	Normal 35 37 早晚
至如梁、柱、枋、標、门、窗、墙、瓦、植、阶、栏杆、隔扇、斗拱、正脊、垂脊、正吻、戗兽、正房、厢房、游廊、庭院、夹道等等。	Hard 34 36 垂脊
可是，手术台是医生的阵地。	Normal 3 6 手术台
穿上这身黑，就赛跟地上一桶白浆较上了劲。	Hard 6 8 就赛
当下茶果已撤，贾母命两个老嬷嬷带了黛玉去见两个母舅。	Normal 7 10 贾母命
赵王到了渑池，会见了秦王。	Hard 4 6 渑池
在春暖时节，有一夜，我在睡梦中好像听到小院书房的窗纸响，第二天发现窗棂上果然撕破了一个洞，显然地是有野猫钻了进去。	Hard 33 35 窗棂
你们试看那些繁殖在南美各地自由自在地生活着的马匹吧：它们行走着，它们奔驰着，它们腾跃着，既不受拘束，又没有节制；它们因不受羁勒而感觉自豪，它们避免和人打照面；它们不屑于受人照顾，它们能够自己寻找适当的食料；它们在无垠的草原上自由地游荡、蹦跳，采食着四季皆春的气候不断提供的新鲜产品；它们既无一定的住所，除了晴明的天空外又别无任何庇荫，因此它们呼吸着清新的空气，这种空气，比我们压缩它们应占的空间而禁闭它们的那些圆顶宫殿里的空气，要纯洁得多，所以那些野马远比大多数家马来得强壮、轻捷和遒劲。	Hard 61 63 羁勒
伯诺德夫人知道，万一蜡烛燃烧到金属管处就会自动熄灭，秘密就会暴露，情报站就会遭到破坏，同时也意味着他们一家三口生命的结束。	Normal 10 12 蜡烛
另外一个伙计使劲地擤鼻子。	Hard 9 10 擤
胡早秋这才看到了西圩堤上的人影，忙掉转车头，迎着水流冲向圩堤。	Hard 9 11 圩堤
这条钢铁大动脉的贯通，彻底解决了人员和物资“进藏难”“出藏难”的问题，必将有力地促进藏族人民与其他各族人民的交流和友谊，促进西藏的经济繁荣和社会发展。	Normal 62 64 西藏
巢窠散落在地面上，小耗子又会发现它们，将毡靴的残毛搬进自己地下的窝中。	Hard 0 2 巢窠
作为酬谢，敬赠一百元。	Normal 7 10 一百元
这儿应该有几声胡笳和羌笛的，音色极美，与自然浑和，夺人心魄。	Hard 7 9 胡笳
这孩子花了整整一年功夫用玳瑁铅笔刀在课桌上刻自己的姓。	Hard 12 14 玳瑁
像鸽子笼一般地分得均匀，每边八排，每排五户，一共八十户一楼一底的房屋，每间工房的楼上楼下，平均住着三十二三个“懒虫”和“猪猡”，所以，除了“带工”老板、老板娘、他们的家族亲戚和穿拷绸衣服的同一职务的打杂、请愿警之外，这工房区域的墙圈里面住着二千左右衣服褴褛而替别人制造衣料的“猪猡”。	Hard 126 128 褴褛
第八回里的一首绝句，嘲讽聊城杨氏海源阁（书中改称东昌府柳家）的藏书，虽不是好诗，却也不是造谣言的。	Normal 7 9 绝句
德居斯太因侯爵对肖邦说过：“我听着您的音乐，总感到是在同您促膝谈心，甚至，似乎是跟一个比您本人更好的人在一起，至少是，我接触到了您身上那点最美好的东西。”	Normal 55 57 至少
用虚设物境来寓情寓意，是本文，也是屠格涅夫的散文的一个特点。	Normal 22 24 散文
刷完牙后，我会将多余的牙膏与水吐在曾用来洗澡的同一块布上，然后除去头发上的香波。	Hard 37 39 香波
回家的路上，我就戴着花脸，倚着舅舅执刀而立，一路引来不少人瞧我。	Normal 15 17 舅舅
作为远游客，我充满兴致地行进在茫茫戈壁茫茫荒漠茫茫瀚海。	Normal 12 14 行进
塘鹅妈妈拍拍翅膀，她张开大嘴笑了起来。	Normal 10 12 张开
范进即将这银子交与浑家打开看，一封一封雪白的细丝锭子，即便包了两锭，叫胡屠户进来，递与他道："方才费老爹的心，拿了五千钱来。	Normal 50 52 老爹
一阵窸窸窣窣的声音，每个人都拿出讲义，端端正正摆在面前。	Hard 2 6 窸窸窣窣
"钱塘江潮"，我们一提到这几个字，心里就不免发生一种景慕的情感。	Normal 20 22 不免
我们退到后面，一个辫子很光的却来领我们到了侧面，指出一个地位来。	Normal 24 26 指出
有的队员用声波探测仪仔细搜索着每一条缝隙，细心地捕捉着废墟里发出的声音；有的队员操作液压钳，剪断纵横交错的一根根钢筋，搜寻着压在废墟下的幸存者……	Normal 2 4 队员
在荷叶底下，石头缝里，旮旮旯旯，不知还隐藏着多少骨朵，都是在岸边难以看到的。	Normal 1 3 荷叶
那时黄被暗杀在美国，我拜读他的《远生遗著》，觉得文笔和观力都是值得钦佩的，但微嫌浅露，缺少含蓄。	Normal 43 45 缺少
但我这时适值没有照相了；他便叮嘱我将来照了寄给他，并且时时通信告诉他此后的状况。	Normal 27 29 时时
那些戴旧毡帽的大清早摇船出来，到了埠头，气也不透一口，便来到柜台前面占卜他们的命运。	Hard 10 12 摇船
但看她模样还周正，手脚都壮大，又只是顺着眼，不开一句口，很像一个安分耐劳的人，便不管四叔的皱眉，将她留下了。	Normal 18 20 顺着
少焉，月出寒阴，微明散布石上，松声倏然自万壑来，客皆悚视寂，觉境愈清，思愈远。	Hard 24 29 客皆悚视寂
有一些科学家不同意“演习说”。	Hard 10 12 演习
郑屠正在门前柜身内坐定，看那十来个刀手卖肉鲁达走到门前，叫声：“郑屠！”	Hard 9 11 坐定
我想，自己如果作了王，这世界会成为一种怎样的光景呢？	Normal 19 21 怎样
手术完成之后，用相同频率的电脉冲刺激换核卵，让苏格兰黑面羊的卵细胞质与芬多席特母羊乳腺细胞的核相互协调，使这个“组装”细胞在试管里经历受精卵那样的分裂、发育而形成胚胎的过程。	Hard 19 21 核卵
外祖母说话好似在用心唱歌，字字句句都像鲜花那样温柔、鲜艳和丰润，一下子就牢牢地打进我的记忆里。	Normal 0 3 外祖母
这闭着的眼睛便看见一切圆满，当前的苦痛不过是“天之将降大任于是人也，必先苦其心志，劳其筋骨，饿其体肤，空乏其身，行拂乱其为”。	Normal 9 11 一切
我记得最清楚的有两个：一个叫杨狗，我前几年回家，才知道他的大名，他现在还活着，一字不识；另一个叫哑巴小(意思是哑巴的儿子)，我到现在也没有弄清楚他姓甚名谁。	Normal 48 50 哑巴
休易的声音尖得像单簧口琴，“没这种事，医生。”	Hard 8 10 单簧
我既不跟着队列跑，也不羡慕战士们那种雄纠纠气昂昂的样子了，甚至觉得他们可嗓子吼得太厉害，会把嗓子弄坏的。	Normal 48 50 弄坏
到快入海时，黄河已显得步履沉重，只能缓缓向前。	Normal 18 20 缓缓
中小户人家，忌讳较少，遇到产妇胎位不正，老娘束手，老娘就会建议：“去请陈小手吧。”	Normal 1 5 小户人家
这位身材高大、精神矍铄的老人，此刻面容极其凝重。	Hard 7 11 精神矍铄
她没有带这种长袍，原因是她从来没有。	Normal 13 15 从来
“终于我们可以在现场捉拿他们了。”	Normal 8 10 现场
要是人人都这么让畜生乱咬一阵，那在这世界上也没个活头了。	Normal 12 14 一阵
这个客官道我酒里有甚么蒙汗药。	Hard 11 14 蒙汗药
白竹布衬衫小凉帽，绣花兜肚彩头巾。	Normal 6 8 凉帽
我是母亲的独根苗，您救了我的命，……	Hard 5 8 独根苗
老头子站起来，拾起篙，撑了一下。	Hard 9 10 篙
其出不出，间不容发。	Hard 5 9 间不容发
狗不叫了，圈里的牛也不再发出哞哞声，马也忘记了踢马房的挡板。	Normal 20 22 忘记
更复射，终不能入石矣。	Hard 7 9 入石
大峡谷之外，荒山秃岭，雪山高原，翻过山口进入大峡谷地区，顿然是另一番景象。	Normal 11 13 雪山
大圣见了，搜的一翅飞起去，变作一只大鹚老，冲天而去。	Hard 17 20 大鹚老
然后他对所有的参议员说：“对参议院里的任何人都一样，如果你们穿的那双鞋是我父亲做的，而它们需要修理或改善，我一定尽可能地帮忙。	Normal 56 59 尽可能
这个人抹一把脸上的水问她们：	Normal 11 13 她们
这是每一个人的命运：如果他达到注定的某一级，预先他并不知道是哪一级，阶梯就从他的脚下消失，好像它是陷阱的盖板，而他也就消失了。	Normal 34 36 阶梯
歧江公园使我们看到了那些被熟视无睹的人们，推开了被时光默默湮没了的“单位”之门，迎面吹来清新怡和的风，听到劳动的人们在歌唱。	Normal 21 23 推开
哲尔赛的旅行成了我们的心事，成了我们时时刻刻的渴望和梦想。	Hard 0 3 哲尔赛
我的双腿血淋淋的，站在洞外，那感觉真像从死神的指缝里侥幸地逃脱出来。	Normal 29 31 逃脱
石崖前面有一条河，河边有一棵大杨树，杨树上住着喜鹊。	Normal 18 20 杨树
太阳光经过三棱镜或水滴的折射，会分成红、橙、黄、绿、蓝、靛、紫、七种颜色。	Hard 5 8 三棱镜
太阳光经过三棱镜或水滴的折射，会分成红、橙、黄、绿、蓝、靛、紫七种颜色。	Hard 28 29 靛
你是个破落户，若是和俺硬到底，洒家倒饶了你。	Hard 15 17 洒家
阳光透过池水射到池底，石笋就像高低不平的折光镜把阳光折射成各种不同的色彩。	Normal 2 4 透过
至于公和私的关系，人和己的关系，应以人为先，正如孔子所说：“君子贵人而残己，先人而后己。”	Hard 30 37 君子贵人而残己
那泼贱贼敢来这里害我！	Normal 6 8 这里
湖面上不时传来阵阵‘克噜——克哩——克哩’的叫声，就像那激动人心的劳动号子：‘弟兄们哪，加油！	Normal 22 24 叫声
道格拉斯寡妇守候在旁边，看汤姆是否遵守规定。	Normal 9 11 旁边
野司、直属队、南下干部再加上六纵，相当于7个旅的人马要从这里渡河，必须要在今明两天全部渡完。	Normal 24 26 人马
他的作品，富于时代精神，具有中国民族风格，反映了人民大众的情感与理想，《黄河大合唱》《生产大合唱》《在太行山上》等已经成为反映二十世纪中国人民英勇奋斗历史的经典篇章。	Normal 38 41 大合唱
中小户人家，忌讳较少，遇到产妇胎位不正，老娘束手，老娘就会建议：“去请陈小手吧。”	Hard 6 8 忌讳
前面还有一两个更紧迫的问题。	Normal 0 2 前面
他们早就形成了对他的主观概念，希望从他身上找见威严非凡的东西，希望看到一个貌似天父的美髯公，集尊贵、轩昂、伟岸、天才于一身。	Hard 42 45 美髯公
不过我的意思，并非说诸君应该都退了学，去看自己喜欢看的书去，这样的时候还没有到来；也许终于不会到，至多，将来可以设法使人们对于非做不可的事发生较多的兴味罢了。	Normal 76 78 罢了
对于现代的文艺作品，那些写得朦朦胧胧的、堆砌了许多华丽的词句的、无病而呻、自作多情的风花雪月的文字，我一看就从脑中抹去；但是那些满带着真情实感、十分质朴浅显的篇章，哪怕只有几百几千字，也往往使我心动神移，不能自已！	Normal 82 84 哪怕
有些恶客在朋友家发现一本好书，顿时暗起杀机，雀跃曰：“哎呀，老哥，借给俺瞧瞧！”	Normal 33 35 借给
《千家诗》中很大一部分诗歌歌咏祖国风物，按春夏秋冬时序编排，打开书往下念，四季风光就活生生地展现在眼前：“成紫千红总是春”，“春城无处不飞花”；“绿树阴浓夏日长”，“五月榴花照眼明”；“青女素娥俱耐冷，月中霜里斗婵娟”；“梅雪争春未肯降，骚人搁笔费评章”……	Hard 101 108 月中霜里斗婵娟
明屠本畯有一首诗，叙述煎荔枝的方法，说“旋沉荔花蜂酿蜜，清香不减蔗浆寒”，大概是关于荔枝蜜最早的记载。	Hard 28 35 清香不减蔗浆寒
有弗学，学之弗能弗措也；有弗问，问之弗知弗措也；有弗思，思之弗得弗措也；有弗辨，辨之弗明弗措也；有弗行，行之弗笃弗措也。	Hard 48 51 有弗行
巨大的漕船，舳舻相接，忙碌的船工从停泊在河边的粮船上卸下沉重的粮包，纤夫们拖着船，逆水行驶，一片繁忙景象。	Hard 3 5 漕船
“喂，三颗钮扣，请你开开门！”	Hard 3 5 三颗
为了改造容易腐蚀的铅硫酸蓄电池，爱迪生试验了差不多五万次，前后用了整整十年。	Normal 33 35 整整
我在田老师门下受业四年，听到上千个故事。	Hard 7 9 受业
于是六国之士，有宁越、徐尚、苏秦、杜赫之属为之谋，齐明、周最、陈轸、召滑、楼缓、翟景、苏厉、乐毅之徒通其意，吴起、孙膑、带佗、倪良、王廖、田忌、廉颇、赵奢之伦制其兵。	Hard 34 36 召滑
她站在山冈上，自豪地喊着：“我长大啦！”	Normal 15 17 长大
如果我不去剪除这一个戕害天性的蟊贼，让他继续为非作恶，岂不是该受天谴吗？	Hard 15 17 蟊贼
这一天，哈墨尔先生特别为我们准备了崭新的字模，上面用漂亮的花体字写着：“法兰西，阿尔萨斯，法兰西，阿尔萨斯。”	Hard 20 22 字模
司马谈临终之时，泪流满面地拉着儿子的手说：“我死之后，朝廷会让你继任我的官职，你千万不要忘记我平生想要完成的史书哇！”	Normal 27 29 朝廷
萨沙·斯米尔诺夫，他母亲的独生子，腋下夹着一件东西，用第二二三号《交易所新闻》包着，露出愁眉苦脸的神情，走进柯谢尔科夫医师的诊室。	Normal 2 3 ·
比方说不题词；不为别人的书写序；不参加任何成果鉴定会；不出席应景活动(如开幕式、剪彩等)；不出国访问；甚至退出一线工作以后，不到外地开会，连天津也不去。	Hard 30 32 应景
骆驼的腿上有一大片胼胝，它就是趴在被太阳晒得滚热的沙子上，也不会烫伤。	Hard 9 11 胼胝
因为没有四肢的阻碍，蛇反而可以深入别的动物无法涉足的领域；明亮的歌喉和绚美的羽毛，将消失于蛇像地狱那样狭长而腥臭的肠胃。	Normal 29 31 明亮
“阳谷县示：为这景阳冈上新有一只大虫，近来伤害人命，见今杖限各乡里正并猎户人等，打捕未获。	Normal 23 25 人命
可是我囚系住它，仍旧让柔弱的枝叶垂在我的案前。	Normal 8 10 仍旧
后来他又发明了耒、耜，告诉人们如何耕种。	Hard 9 10 耜
突然，我眼前一亮，小刺猬钻出水沟眼儿，径直向枣树底下跑过来。	Normal 22 24 枣树
爸爸不愧是作家，跟自己的亲骨肉也咬文嚼字，而且也不肯赏一句振奋人的话。	Hard 16 20 咬文嚼字
比如文章开始，仅用“滋润美艳”四个字，就将江南雪的特质准确地概括出来，并因为它同时调动了视觉、触觉，所以给读者的印象鲜明而深切。	Normal 47 49 触觉
只是它的联想的意义迷离不易捉摸，它可以联想到燃烧弹，鸦片烟榻，庙里焚香，“一川烟水”，“杨柳万条烟”，“烟光凝而暮山紫”，“蓝田日暖玉生烟”……	Hard 44 49 杨柳万条烟
⑸“秩秩斯干幽幽南山”：语见	Hard 2 10 秩秩斯干幽幽南山
今诸君苟不于此时植其基，勤其学，则将来万一因生计所迫，出而仕事，但任讲席，则必贻误学生；置身政界，则必贻误国家。	Hard 27 31 出而仕事
我心里不由得泛起一阵同情和怜悯，大家都屏息凝神地望着他。	Normal 3 6 不由得
玄德徐步而入，见先生仰卧于草堂几席之上。	Hard 15 17 几席
比如说“烟”，它的直指的意义见过燃烧体冒烟的人都会明白。	Normal 19 21 冒烟
士兵们不由得呻吟颤抖起来。	Normal 3 6 不由得
有弗学，学之弗能弗措也；有弗问，问之弗知弗措也；有弗思，思之弗得弗措也；有弗辨，辨之弗明弗措也；有弗行，行之弗笃弗措也。	Hard 0 3 有弗学
首先，我购买了少量的钠22，它是一种能够自然地放射正电子（电子的反物质）的放射性物质。	Hard 32 35 反物质
这是因为地壳下沉，使原来靠岸的地方变成了海洋的中心。	Hard 4 6 地壳
溪西一带山，俱似鹦绿鸦背青，上有腥红云五千尺，开一大洞，逗出缥天，映水如绣铺赤玛瑙。	Hard 39 41 玛瑙
《千家诗》中很大一部分诗歌歌咏祖国风物，按春夏秋冬时序编排，打开书往下念，四季风光就活生生地展现在眼前：“成紫千红总是春”，“春城无处不飞花”；“绿树阴浓夏日长”，“五月榴花照眼明”；“青女素娥俱耐冷，月中霜里斗婵娟”；“梅雪争春未肯降，骚人搁笔费评章”……	Hard 119 126 骚人搁笔费评章
人们，在这山水中返璞归真了。	Hard 8 12 返璞归真
比如说苏东坡的“惠山烹小龙团”诗里三四两句“独携天上小团月，来试人间第二泉”，“天上小团月”是由“小龙团”茶联想起来的，如果你不知道这个关联，原文就简直不通。	Hard 8 14 惠山烹小龙团
我没听清他应的是什么，明白是正需要我“帮一把”的意思，就赶快绕到车后，一点也不隐藏力气地推起来。	Normal 41 43 力气
大自然这番壮美的景象，引起了鲁迅美好的回忆和辽远的退想。	Hard 25 27 退想
“大家都在外面等待，准备好了华盖，以便举在陛下头顶上去参加游行大典。”	Hard 14 16 华盖
他告诉我，这索桥又叫做“何公何母桥”，是清朝初年一个姓何的教书先生设计修建的。	Hard 6 8 索桥
可是罗马市区的交通真是糟糕，走着走着就堵车，我心里急得要死，看看出租车司机，他倒是一副习以为常的样子，我听妈妈用英语和他交谈，也用英语插嘴，问司机我们去晚了，斗兽场是否会关门。	Normal 32 35 出租车
冬天里四面透风，柳木疙瘩火当中架起，一出场一脸正经，一下场凑近火堆，热了前怀，凉了后背。	Hard 10 12 疙瘩
自然是江南日暮的雪景；“寒沙梅影路，微雪酒香村”，则雪月梅的冬宵三友，会合在一道，在调戏酒姑娘了；“柴门闻犬吠，风雪夜归人”，是江南雪夜更深人静后的景况；“前村深雪里，昨夜一枝开”，又到了第二天的早晨，和狗一样喜欢弄雪的村童来报告村景了。	Hard 12 17 寒沙梅影路
要达到这样的境界并不容易，比如当今世界上许多发展中国家，历史上大多遭受过西方殖民主义的欺凌，这些国家的民众，由于受一种被扭曲的心理的影响，容易产生两种截然相反的倾向：一种是妄自菲薄，盲目崇拜西方；一种是闭关排外，甚至极端仇视西方。	Normal 110 112 仇视
“下雨了”，温柔的灰美人来了，她冰冰的纤手在屋顶拂弄着无数的黑键啊灰键，把晌午一下子奏成了黄昏。	Normal 6 8 温柔
至于公和私的关系，人和己的关系，应以人为先，正如孔子所说：“君子贵人而残己，先人而后己。”	Normal 22 24 正如
我们看诗人动不动就说“秦时明月汉时关，万里长征人未还”，动不动就说“男儿何不带吴钩？	Hard 34 41 男儿何不带吴钩
啪啪声里，一道道浆，衔接得天衣无缝，刷过去的墙面，真好比平平整整打开一面雪白的屏障。	Normal 26 28 好比
《千家诗》中很大一部分诗歌歌咏祖国风物，按春夏秋冬时序编排，打开书往下念，四季风光就活生生地展现在眼前：“成紫千红总是春”，“春城无处不飞花”；“绿树阴浓夏日长”，“五月榴花照眼明”；“青女素娥俱耐冷，月中霜里斗婵娟”；“梅雪争春未肯降，骚人搁笔费评章”……	Hard 111 118 梅雪争春未肯降
但这种乐趣保留在运动员内心深处，在某种程度上只是自得其乐。	Normal 3 5 乐趣
看着人类这种狂妄的表现，大自然一定会窃笑——就像母亲面对无知的孩子那样的笑。	Normal 28 30 无知
没什么可抱怨的。	Normal 0 3 没什么
可是每星期日，我们都要衣冠整齐地到海边栈桥上去散步。	Hard 19 21 栈桥
船长本已不耐烦我父亲那番谈话，就冷冷地回答说：“他是个法国老流氓，去年我在美洲碰到他，就把他带回祖国。	Normal 0 2 船长
四百多年里，它剥蚀了古殿檐头浮夸的琉璃，淡褪了门壁上炫耀的朱红，坍圮了一段段高墙又散落了玉砌雕栏，祭坛四周的老柏树愈见苍幽，到处的野草荒藤也都茂盛得自在坦荡。	Hard 32 34 坍圮
这所谓灵柩，其实只是一卷用绳子捆着的芦席，说书人的脚从席子里露出来，不住随着杠手的步骤摆动，他的破长衫的一角直垂到地上，一路上扫着路上的浮土。	Hard 38 40 杠手
遗憾的是，人们却很少从这些书中汲取有益的见解。	Normal 8 10 很少
一条短尾巴的大黑狗已经围着他的双腿起劲地跳起舞来，酒店里的人们的目光都快活地抛向他。	Normal 7 9 黑狗
(《古诗十九首》)“家在梦中何日到，春来江上几人还严(卢纶)“不知何处吹芦管，一夜征人尽望乡。”	Normal 2 4 古诗
我空着肚子，又推了几步，实在推不动了，产生了“偷劲”的念头。	Hard 23 25 偷劲
更羸仔细看了看，指着大雁对魏王说：“大王，我不用箭，只要拉一下弓，这只大雁就能掉下来。”	Hard 0 2 更羸
然后我建造了一个云室，在云室中可以看到亚原子粒子留下的踪迹。	Hard 8 10 云室
一面是旗帜，木棒，呼喊与愤怒，一面是居高临下，一尊机关枪同十支步枪。	Normal 9 11 呼喊
麋鹿的自然繁殖力很低，雌鹿的怀孕期比其它鹿类要长，超过九个半月，且每胎仅产一仔。	Hard 5 8 繁殖力
静候一旁的考察队员按捺住激动的心情,像守候着一只易碎的宝瓶一样,小心翼翼地观察着,悄悄地拍摄照片,生怕惊飞了这两只珍稀的鸟儿。	Normal 49 51 生怕
此后又有近处的本家和亲戚来访问我。	Hard 7 9 本家
在独自一人百无聊赖时，我便玩单人纸牌游戏。	Normal 18 20 游戏
队伍翻过了一座大山，眼前是一块平坦的山场，贺龙同志仔细观察了地形，然后传了一道命令，要全体指战员把草帽摘下丢在路边。	Hard 45 48 指战员
不是我口浅，量你是个遭死的军人，相公可怜，抬举你做个提辖，比得草芥子大小的官职，直得恁地逞能。	Normal 16 18 相公
一位弱不禁风的姑苏少女，怎么会成为闻名世界的优秀运动员呢？	Normal 9 11 少女
据后代文人考订，《清明上河图》可能作于政和至宣和年间，那正是北宋统治者在覆灭之前大造盛世假象，以此掩盖内忧外患的时期，建炎之后，南渡的北宋遗民怀念故土，在他们眼中，这副图卷必有其特殊的意义，正是他们回首故土，梦回繁华的写照。	Hard 5 7 考订
它不仅仅成了波兰人朝拜的圣地，举行精神宴会的殿堂，参观游览的古迹，而且为数众多的外国音乐家、钢琴家、作曲家都把造访这个伟大艺术家的摇篮、这个喷射出了肖邦伟大音乐的不竭源泉，看成自己一生的夙愿。	Hard 93 95 夙愿
你以为师傅的能耐有假，名气有诈，是吧。	Normal 11 13 名气
新写的《国榷》共104卷，428万4千字，内容比原先的那部更加翔实、精彩，是一部不可多得的明史巨著。	Hard 4 6 国榷
无智慧的书，往往材料堆积得和蚁丘一样，议论虽多，见解毫无。	Hard 14 16 蚁丘
夏洛克，不行，不行，我已经对天发过誓啦，难道我可以让我的灵魂背上毁誓的罪名吗？	Normal 35 37 罪名
南极离得越来越近了，她拿着一只用蜡封严瓶口的啤酒瓶，兴冲冲跑到右舷。	Hard 31 33 右舷
他发现了黑洞的蒸发性，推论出黑洞的大爆炸……	Normal 1 3 发现
作为最高的效果，它格外赏赐了只属于幸福的少数人的，极罕见的摄身光。	Hard 29 32 摄身光
第一种是躺着读，这是陶渊明所标榜的好读书不求甚解，但是他自己并不一定实行的办；而大多数文学爱好者就是这样读的，其特点是没有固定的目的，真所谓博览群书。	Normal 61 63 固定
孙中山小的时候在私塾读书．那时候上课，只是先生念，学生跟着读，然后把读的段落背诵下来．至于书里的意思，先生从来不讲解。	Normal 12 13 ．
要是暂时经过苦难，重新克服了困境，就会说：“两岸猿声啼不住，轻舟已过万重山！”	Hard 26 27 啼
詹天佑经常勉励工作人员说：“我们的工作首先要精密，不能有一点儿马虎，‘大概’，‘差不多’，这类说法不该出自工程人员之口。”	Normal 28 31 一点儿
她没答理跑来讨好自己的叭儿狗，没去看心爱的小羊羔儿，不理睬调皮的小牛犊儿。	Hard 11 14 叭儿狗
同是这座树林，当晚秋山鹬飞来的时候，显得多么美好啊！	Hard 9 12 秋山鹬
考察队员和村民们认真仔细地搜索、观察,在附近一共发现了七只成年朱鹮,他们立即投入到紧张的保护朱鹮的工作之中。	Hard 31 33 朱鹮
要是你看到一张他赶着马车外出的照片，还有个白胡子随从与他并排坐着，你也许要动脑筋想上好一阵，才能判断手握缰绳的是马车夫，坐在一旁的是伯爵。	Normal 24 26 随从
5米，可以说是罕见的庞然大物。	Normal 3 5 可以
这样的游记不但感性单薄，文字也平凡，多袭前人之句。	Hard 19 20 袭
实际上，这个黑色小鼠的受精卵在精细胞核刚进入卵细胞后，就把精细胞核连同卵细胞的核一起除去。	Normal 42 44 除去
这种颜色，我就叫它“阜平蓝”或是“山地蓝”吧。	Hard 10 13 阜平蓝
这些生物的智慧是我们所无法比拟的。	Normal 2 4 生物
吃饭时让它坐在旁边，用羹匙喂它；当我把什么东西抹到它嘴上时，它那张小脸儿十分逗人，简直像活了似的。	Hard 11 13 羹匙
目前实际生活中，作风常常指机关干部的工作方法与效率，如作风拖拉，作风生硬，缺少民主作风，作风雷厉风行等说法，系指工作中表现的个人特点是性格与习惯方面的特点，至于经验、知识、智商方面的状况则用“水平”一词来表示，道德特点用“品质”（原专指物品的质量质地的，指人则称品格。	Normal 86 88 智商
黄翅飞蝗泥蜂的幼虫赖以为生的猎物，尽管有时完全不能动弹，却不是真正的尸体。	Hard 2 6 飞蝗泥蜂
既然是夜间，各种色相都隐退了，一切色彩斑斓的词汇也就失去了效能；又在下雨，空间十分逼仄，任何壮举豪情都铺展不开，诗句就不能不走向朴实，走向自身，走向情感，李商隐著名的《夜雨寄北》堪称其中典范。	Normal 93 95 典范
天也晚了，不虚留你们了。	Hard 6 8 虚留
我陪他去参观展览，他对于中纺的织纺，对于那些改良的新农具特别感到兴趣。	Normal 26 28 农具
每到水势缓慢的洄水涡，都有鱼儿在欢快地跳跃。	Hard 7 10 洄水涡
在轻松幽雅的乐曲声里，只见他头上顶着高高的一摞金边红花白瓷碗，柔软而又自然地舒展着肢体，做出各种各样令人惊羡的动作，忽而卧倒，忽而跃起……	Normal 58 60 忽而
舒活舒活筋骨，抖擞抖擞精神，各做各的一份儿事去，“一年之计在于春”;刚起头儿，有的是工夫，有的是希望。	Hard 25 32 一年之计在于春
在中国最早的新闻学著作之一《实际应用新闻学》中，邵飘萍主张记者“其脑筋无时休息，其耳目随处警备，网罗世间一切事物而待其变。”	Hard 45 47 警备
今诸君苟不于此时植其基，勤其学，则将来万一因生计所迫，出而仕事，但任讲席，则必贻误学生；置身政界，则必贻误国家。	Hard 44 48 置身政界
后来，汉朝政府在张骞走过的路上设置了四个郡，这条以长安为起点，经过河西四郡，一直通向印度、西亚乃至欧洲的交通要道——丝绸之路就畅通无阻了。	Normal 25 27 长安
飞机在高空盘旋，鲜花伴着骨灰，撒向无垠的大海。	Hard 17 19 无垠
她们躺的地方，到了一定的时间是非让出来做吃粥的地方不可的，可是在那一天，芦柴棒可真的挣扎不起来了，她很见机地将身体慢慢地移到屋子的角上，缩做一团，尽可能地不占地方。	Hard 51 53 见机
学会了怎样用潜水镜以后，你就可以背上氧气瓶穿上脚蹼，在小湖或江河里，一边蹬水悠闲地游来游去，一边观察水底。	Hard 23 25 脚蹼
徽曰：“孔明与博陵崔州平、颍川石广元、汝南孟公威与徐元直四人为密友。	Hard 7 9 博陵
孩子们会感受爱了，但这还不够。	Normal 12 14 不够
我多么高兴，又多么渴望地伸手去拿，但和我的手同时抵达的，还有一双巨掌，十个手指大大地分开来，整个地压住了那本书:“你到底买不买？”	Normal 37 39 手指
他们开步走，手中托着空气棗他们不敢让人瞧出他们实在什么东西也没看见。	Hard 12 13 棗
但他终于不放心，怕茶房不妥帖；颇踌躇了一会。	Normal 2 4 终于
《红楼梦》第四十九回里就有这样一段：“黛玉换上掐金挖云红香羊皮小靴，罩了一件大红羽绉面白狐皮的鹤氅，系一条青金闪绿双环四合如意绦，上罩了雪帽。”	Hard 61 64 如意绦
北京时间上午9时30分，年轻的登山队员——运动健将王富洲、刘连满、屈银华和一级运动员贡布(藏族)四人，背着高山背包，扶着冰镐，开始向珠穆朗玛顶峰最后的380米高度冲击。	Hard 60 62 冰镐
在時天之下，旋风忽来，使连勃地奇飞，在日光中灿灿地生光，如色火的大雾，旋转而且升腾，弥没太空，使太空旋转而且升勝地闪烁鲁迅憎恶这使雪花永远“如粉，如沙”地旋转飞腾的方的冬天，同时又赞颂这与“凛冽的天宇”奋飞搏战的孤独而低强的“雨的精魂”。	Hard 1 3 時天
人的身体虽然小，但据说因为是神创造的，相貌和举动也有些像神，和飞的鸟、爬的兽都不相同，看起来似乎便有一种管理宇宙的非凡的气概。	Normal 19 21 相貌
我赶紧拭干了泪，怕他看见，也怕别人看见。	Normal 1 3 赶紧
至如梁、柱、枋、標、门、窗、墙、瓦、植、阶、栏杆、隔扇、斗拱、正脊、垂脊、正吻、戗兽、正房、厢房、游廊、庭院、夹道等等。	Hard 37 39 正吻
雨中游人稀少，静谧的湖山，都由爱雨的人管领了。	Hard 19 21 管领
夜来风雨声，花落知多少？	Hard 6 11 花落知多少
我父亲没的时候，我年纪又小，不知事体。	Normal 9 11 年纪
人们的诵经声和讨价还价的嘈杂声混在一起，香炉中吐出的桑烟香味与外国香水的气味混在一起，古老质朴的藏戏唱腔与节奏激烈的迪斯科乐曲混在一起……。	Hard 50 52 唱腔
另外还要个拦头工人，上滩下滩时看水认容口，出事前提醒舵手躲避石头，恶浪与洑流，出事后点篙子需要准确，稳重。	Hard 42 45 点篙子
悼公于是决定由祁午继任中军慰。	Hard 11 14 中军慰
刘鹗先生是个很有文学天才的人；他的文学见解也很超脱。	Hard 0 2 刘鹗
本着这个精神，他随处留心玩索，无论是阅读或写作，就会逐渐养成创作和欣赏都必需的好习惯。	Hard 12 14 玩索
围观的农民非常奇怪，一位老人拍拍沃特森的肩膀，说：“小伙子，你是在喊屋里的那个人吗？	Normal 20 22 肩膀
它的社论是有名的，我在中学时，老师经常选来给我们当课文讲。	Hard 2 4 社论
从那以后，一队队骆驼商队在这漫长的商贸大道上行进，他们越过崇山峻岭，将中国的养蚕、缫丝、冶铁、造纸、凿井、灌溉等技术带向中亚、西亚和欧洲，将那里的葡萄、核桃、石榴、蚕豆、黄瓜、芝麻、无花果等食品带到我国，还有狮子、犀牛、良马等动物，也传进了我国。	Hard 41 43 缫丝
他带着我一堆一堆地去拜访，不慌不忙的，直到天亮为止。	Normal 23 25 为止
于是架起两支橹，一支两人，一里一换，有说笑的，有嚷的，夹着潺潺的船头激水的声音，在左右都是碧绿的豆麦田地的河流中	Hard 29 31 潺潺
他发现：根据爱因斯坦的公式，铀的链式反应所释放出的能量，威力比普通炸弹不知高出多少倍，刹那间，能把干万生命烧成灰烬。	Hard 14 15 铀
伽西莫多又显出筋疲力尽的样子，他脸上的呆笨表情变成了痛苦和懊丧，他闭上独眼，把头垂到胸前，仿佛死去了似的。	Normal 19 21 呆笨
这也是千古名句，可是这里的“高树多悲风”却并没有落叶的形象，而“寒风扫高木”则显然是落叶的景况了。	Hard 32 37 寒风扫高木
一个人呷了一口酒，幽幽地提出疑问。	Hard 9 11 幽幽
假如你要报恩，那就请你回去后，不要对人说我在这里，因为人们贪图我的皮角，万一坏人知道了，一定会来伤害我的。	Normal 38 40 坏人
如果不是有人发明了火车，如果不是有人把铁轨铺进深山，你怎么也不会发现台儿沟这个小村。	Normal 6 8 发明
什么都有：稻鸡，角鸡，鹁鸪，蓝背……	Hard 11 13 鹁鸪
在这里，谁都不叫喊吆喝，牛的脖子上的铃铛也没有响声，挤奶的人更是默默无言。	Normal 23 25 响声
我庆幸它居然没有被卖出去，仍四平八稳地躺在书架上，专候我的光临。	Normal 21 24 书架上
五十年代初的麦卡锡时代，是美国历史上的一段黑暗时期，许多正直的美国科学家也无端地受到迫害，所以那一段时间美国政府那样对待钱是很不公正的，我查过当时的档案，我这么评价是有根据的。	Normal 28 30 正直
我想像它看到一只野免，因人类的扩张在平原上已近绝迹的野兔，梭罗在《瓦尔登湖》中预言过的野兔：“要是没有兔子和鹧鸪，一个田野还成什么田野呢？	Hard 54 56 鹧鸪
林园园从盒子里拿出绿铅笔，说：“你要注意，不要削，画的时候不要用力，不要画得太多。”	Normal 4 6 盒子
四叔皱了皱眉，四婶已经知道了他的意思，是在讨厌她是一个寡妇。	Hard 27 29 寡妇
松鼠不像山鼠那样，一到冬天就蛰伏不动。	Hard 14 16 蛰伏
刘伯承狠狠地教训了他一顿后，给他解开脚上的套绳，叫他向在场的细娃作揖赔礼后，才命令他滚蛋。	Hard 30 32 细娃
大平原托着的小屯里，左邻右舍的窗子上，都贴着姥姥心灵手巧的劳作。	Hard 6 8 小屯
不更事的勇敢的少年，往往敢于给人解决疑问，选定医生，万一结果不佳，大抵反成了怨府，然而一用这说不清来作结束，便事事逍遥自在了。	Hard 38 40 怨府
我家只有一个忙月（我们这里给做工的分三种：整年给一定人家做工的叫长年；按日给人做工的叫短工；自己也种地，只在过年过节以及收租时候来给一定的人家做工的称忙月），忙不过来，他便对父亲说，可以叫他的儿子闰上来管祭器的。	Normal 43 45 短工
然而，水流这时已经很急，转眼间涨到近半米，吉普车没能如愿冲到圩堤前就熄了火，二人只好弃车徒步往堤上奔。	Hard 30 32 圩堤
梁中书道：“礼物多已拴缚完备，如何又去不得？”	Normal 6 8 礼物
至如梁、柱、枋、標、门、窗、墙、瓦、植、阶、栏杆、隔扇、斗拱、正脊、垂脊、正吻、戗兽、正房、厢房、游廊、庭院、夹道等等。	Normal 22 24 栏杆
设有一对夫妇，他们患有不育症，虽然现在不育症可以用人工授精（男方不育）、体外受精（女方不肯）或代理母亲（女方不能怀孕）解决，但夫妻双方不愿意，也不愿领养别人的孩子。	Hard 25 29 人工授精
两岸连山，略无阙处。	Hard 5 9 略无阙处
孙晋芳是江苏人，说一口像音乐似的婉转动听的苏州乡音。	Normal 21 23 苏州
后来，我在久别之后尝到了，也不过如此；惟独在记忆上，还有旧来的意味存留。	Normal 5 7 久别
众邻居道：“老爷，恭喜高中了。	Normal 9 11 恭喜
我乘她不再紧接的问，迈开步便走，匆匆的逃回四叔的家中，心里很觉得不安逸。	Hard 33 35 安逸
到了夏季，冰雪消融了，北极熊转移到陆上生活，这时，食物来源丰富了，北极熊不必为猎食而整天奔波。	Normal 11 14 北极熊
但是谁也不敢说一句阻拦他的话，也没有一个人敢伸出手去向他握别。	Normal 9 11 阻拦
这时的旅鼠不再胆小怕事，见人就跑，而是恰恰相反，在任何天敌面前它们都显得勇敢异常，无所畏惧，具有明显的挑衅性，有时甚至会主动进攻，真有点天不怕地不怕的样子。	Normal 66 68 有点
它把自己的兄弟姊妹连成一个整体，去抵御狂风恶浪，减少海啸带来的自然灾害。	Normal 13 15 整体
春风无迹可寻，但春风一至，江南倏忽绿了，那么突然，又那么自然。	Hard 15 17 倏忽
街道既那么窄，结果站在最前线上的特派员同四十多个青年学生与农民，便全在城门边牺牲了。	Normal 35 37 城门
它好像听懂了我的话，撒娇似的的吮着我的大拇指，用头蹭着我的膝盖，鼻子里发出轻轻的哼声。	Hard 15 16 吮
大紫檀雕螭案上，设着三尺来高青绿古铜鼎，悬着待漏随朝墨龙大画，一边是金蜼彝，一边是玻璃。	Hard 34 37 金蜼彝
时云长在侧曰：“某闻管仲、乐毅乃春秋、战国名人，功盖寰宇；孔明自比此二人，毋乃太过？”	Hard 24 28 功盖寰宇
江理以“从者七人，二僧与俱”，组成一支浩浩荡荡的登山队，“一仆前持斧斤，剪伐丛莽，一仆鸣金继之，二三人肩糗执剑戟以随。”	Normal 23 24 的
他坐着船饶有兴趣地在水面上转了儿圈，他站在船头四下远眺，感叹这里的美景。	Normal 33 35 美景
这明明是饥饿表演提前收场的结果，大家却把它解释为饥饿表演之所以结束的原因！	Normal 10 12 收场
后来，黑子不再信赖它的训导员，甚至不再信赖所有的人。	Hard 11 14 训导员
旧籍记载荔枝，说到有的品种皮粗厚，刺尖，唐代徐夤诗云“龙绢壳绽红纹粟”，就已观察到这种构造。	Hard 22 24 徐夤
他发现了黑洞的蒸发性，推论出黑洞的大爆炸……	Hard 7 10 蒸发性
据说，许多年代以前，威尼斯还是一片荒芜的海滩，马可到意大利各地传教，乘船经过里阿托岛海岸，当时风暴骤起，把船刮到荒凉的沼泽地带搁浅了。	Hard 31 33 传教
这时候，天还没有完全黑，他便借着留连的暮色，在乱石中间摸索着，想找到一些干枯的苔藓。	Normal 25 27 中间
漂载着野花，漂载着山草和林苔的清香，漂载着快乐，漂载着喜悦和云彩的影子，泉水在山箐里响起来了！	Hard 39 41 山箐
真要勉用文字来着色，也不过像谢灵运的一些名句“云日相晕映，空水共澄鲜”或是“出谷日尚早，入舟阳已微。	Hard 29 34 空水共澄鲜
是谁又吹响了那欢快、柔美的麦哨？	Normal 7 9 欢快
今诸君苟不于此时植其基，勤其学，则将来万一因生计所迫，出而仕事，但任讲席，则必贻误学生；置身政界，则必贻误国家。	Hard 51 53 贻误
我到柴房去搬些柴生个火吧。	Normal 2 4 柴房
博识的人们觉得他单调，他自己也以为不幸否耶？	Hard 19 21 否耶
有弗学，学之弗能弗措也；有弗问，问之弗知弗措也；有弗思，思之弗得弗措也；有弗辨，辨之弗明弗措也；有弗行，行之弗笃弗措也。	Hard 4 11 学之弗能弗措也
四川一个偏僻的地方住着两个和尚：一个贫穷，一个富有。	Normal 13 15 和尚
蔺相如的话到了廉颇的耳朵里。	Normal 3 5 的话
他说道，“但有一个条件：如果你不能在当天返回出发地点，你就将白白失去那一千卢布。”	Hard 37 39 卢布
回来的路程危险增加了十倍，在前往极点的途中只要遵循罗盘的指引，而现在他们还必须顺着自己原来的足迹走去，在几个星期的行程中必须小心翼翼，绝对不能偏离自己原来的脚印，以免错过事先设置的贮藏点——在那里储存着他们的食物、衣服和凝聚着热量的几加仑煤油。	Normal 16 18 极点
待到学校恢复旧观，往日的教职员以为责任已尽，准备陆续引退的时候，我才见她虑及母校前途，黯然至于泣下。	Hard 43 45 黯然
她第一次听清它们在夜晚，在风的怂恿下“豁啷啷”地歌唱。	Normal 9 11 夜晚
公安人员回答，他们是奉了上级指示，闭园接待首长的。	Normal 19 21 接待
每当我们读文天祥的《正气歌》“天地有正气，杂然赋流形，下则为河岳，上则为日星……”	Hard 30 32 河岳
周总理一手端着盛满清水的银碗，一手拿着柏树枝蘸了水，向人们泼洒，为人们祝福。	Hard 22 23 蘸
况且如今这个货也短，你就拿现银子到我们这不三不四的铺子里来买，也还没有这些，只好倒扁儿去。	Hard 40 44 倒扁儿去
每年秋天，我的庶祖母同我到田里去“监割”（顶好的田，水旱无忧，收成最好，佃户每约田主来监割，打下谷子，两家平分），我总是坐在小树下看小说。	Hard 7 10 庶祖母
而细菌得天独厚的是，其繁殖速度极快。	Normal 1 3 细菌
在晴天，我们还会偶见一种高积云。	Normal 1 3 晴天
“逃荒去，债也赖了，会钱也不用解了，好打算，我们一块儿去！”	Hard 10 12 会钱
均曰：“少坐献茶。”	Hard 4 8 少坐献茶
前者正要借满树叶子的吹动，表达出像海潮一般深厚的不平，这里叶子越多，感情才越饱满；而后者却是一个叶子越来越少的局面，所谓“扫高木”者岂不正是“落木千山”的空阔吗？	Normal 10 12 吹动
到了巴黎，找到餐馆跑堂的工作，就开始跟这位世界名提琴师学提琴。	Normal 24 26 提琴
茶罢，孔明曰：“昨观书意，足见将军忧民忧国之心；但恨亮年幼才疏，有误下问。”	Hard 25 26 恨
贾芸便呆呆的坐到晌午，打听凤姐回来。	Normal 11 13 打听
到了河边，见那只新船正在装货，许多油篓子搁到河岸边。	Hard 17 20 油篓子
回家的路上，我就戴着花脸，倚着舅舅执刀而立，一路引来不少人瞧我。	Hard 10 12 花脸
后来他又发明了耒、耜，告诉人们如何耕种。	Hard 7 8 耒
我们退到后面，一个辫子很光的却来领我们到了侧面，指出一个地位来。	Normal 4 6 后面
既然你要求公道，我就给你公道，而且比你所要求的更地道。	Hard 5 7 公道
鲧在临死前叮嘱儿子禹“一定要把洪水治好”。	Hard 0 1 鲧
比如说苏东坡的“惠山烹小龙团”诗里三四两句“独携天上小团月，来试人间第二泉”，“天上小团月”是由“小龙团”茶联想起来的，如果你不知道这个关联，原文就简直不通。	Hard 22 29 独携天上小团月
他说道，看着牛虻伤肿的手臂，“你可以仍然住在原来的牢房里，死因牢又黑又暗。”	Hard 6 8 牛虻
因此，挨打时，他总是说：“不痛，不痛。”	Normal 8 10 总是
它从石洞里流出来，又一滴一滴渗进石缝里去，把石块碾成的粉末变成了泥土。	Normal 27 29 粉末
齐鲁青未了”，这“青未了”三个字，不正是生生不息的春色天边无际地流淌么？	Hard 0 5 齐鲁青未了
海风猛烈地吹，澎湃的波涛把海里的泥沙卷到岸边。	Normal 0 2 海风
那只雄吐绶鸡一生下来脚上就有距，因此他就以为自己是一个皇帝。	Hard 14 15 距
宫内500多间大殿小厅，处处金碧辉煌，豪华非凡。	Normal 7 9 大殿
当然，郎平年轻气盛，性子也直，老扣不死球，心里焦急，说话口气可能冲了一点，但郎平自己并没有意识到，何况这是一个误会呢。	Normal 55 57 误会
下了一夜的雨，第二天太阳出来一蒸发，草间的菌子，俯拾皆是：有的红如胭脂，青如青苔，褐如牛肝，白如蛋白，还有一种赭色的，放在水里立即变成靛蓝的颜色。	Hard 55 57 赭色
他举起右臂，手雷在按照灯的光亮中闪闪发光。	Hard 6 8 手雷
1943年，美国军方经过慎重的选择，委托钱学森同马林纳合作，研究用火箭发动机推进导弹这一重大军事课题。	Normal 20 23 钱学森
从下午两三点钟起，陪到夜里十二点，这么长的时间，鲁迅先生都是坐在藤躺椅上，不断地吸着烟。	Normal 11 13 夜里
这时舷窗已经烧得黑乎乎的，我坐在里面，怀抱着操作盒，屏息凝神地等待着配合程序：到哪里该做什么，该发什么指令，判断和操作都必须准确无误。	Hard 2 4 舷窗
既已不平凡不单调了，又毋需乎创造。	Hard 11 13 毋需
我家只有一个忙月，忙不过来，他便对父亲说，可以叫他的儿子闰土来管祭器的。	Normal 17 19 父亲
溪西一带山，俱似鹦绿鸦背青，上有腥红云五千尺，开一大洞，逗出缥天，映水如绣铺赤玛瑙。	Hard 6 8 俱似
“多利”不是由母羊的卵细胞和公羊的精细胞受精的产物，而是“换核卵”一步一步发展的结果，因此是“克隆羊”。	Hard 20 22 受精
于是，我们的祖先便希望自己的图腾具有风雨雷电那样的力量，群山大河那样的雄姿，让它像鸟一样能腾云驾雾，像鱼一样可以在水中游弋，像马一样可以飞快奔跑……	Normal 68 70 飞快
有一天，我在我家八字门口和一班孩子“掷铜钱”，一位老辈走过，见了我，笑道：“穈先生也掷铜钱吗？”	Hard 38 39 穈
我有一时，曾经屡次忆起儿时在故乡所吃的蔬果：菱角、罗汉豆、茭白、香瓜。	Normal 19 21 蔬果
骈偶的来源很古。	Hard 0 2 骈偶
人们只怕不会做梦，光剩下一颗枯焦的心儿，一片片逐渐剥落。	Normal 6 8 做梦
水在颤动中发出淙淙声响，青草仿佛在这乐声中生长，水影显得那么调和。	Hard 7 9 淙淙
到得岭下，早有七八十人都哄将来，先把死大虫抬在前面，将一乘兜轿，抬了武松，径投本处一个上户家来。	Hard 29 31 兜轿
然后再放置到城市需要绿化的地方去。	Normal 6 8 城市
“推”可以无声，“敲”就不免剥啄有声，惊起了宿鸟，打破了岑寂，也似乎频添了搅扰。	Normal 25 27 打破
街上突然加多了人，铺子里的人争着往外跑，都攥着把蒲扇遮着头，四下里找。	Normal 9 11 铺子
哥伦布噙着眼泪点了点头……	Hard 3 4 噙
因为宇宙辽阔无垠，所以那些我们所熟悉的适用于地球的量度单位——米、英里等等已经没有意义。	Normal 2 4 宇宙
再进去；他果然躺在草窠里，肚里的五脏已经都给吃空了，手上还紧紧的捏着那只小篮呢。……	Hard 9 11 草窠
考古学者对700多个秦俑逐个测量，发现它们的形体、结构、比例、质感都以准确的解剖结构为依据，连手指关节的长短、肌肉的厚薄、眼角眼皮的轮廓都合情合理。	Normal 61 63 眼角
旧耻已湔雪，中国应新生。	Hard 3 5 湔雪
经过郊区，我闻到刺鼻的化学品烯燃烧的气味，湾里的小商人焚烧电缆。	Normal 18 20 气味
大花蝴蝶飘飘荡荡落在一朵蒲公英上，我正想猛扑过去，忽然发现前边的草丛中有一个黑乎乎的人影。	Normal 12 15 蒲公英
爸爸放的是爆竹，声音真大，可怕极了，虽然关紧了门，捂住了耳朵，也照样听得见。	Normal 28 30 耳朵
城春草木深，孟夏草木长。	Hard 0 5 城春草木深
每天回家，曲折穿过金门街到厦门街迷宫式的长巷短巷，雨里风里，走入霏霏令人更想入非非。	Hard 32 34 霏霏
《易经》和《老子》大部分是韵语，《庄子》等书也有一些韵语。	Hard 13 15 韵语
然而划过了，幔又合拢，跟没有划过的时候一样，透不进一一丝儿风，一会儿，长空一闪，又是那灰色的幔裂了一次缝。	Hard 6 7 幔
已不能再用它写作，只能写便笺或信封。	Normal 15 17 信封
他聚集起许多细流，合成一股有力的洪涛，向下奔注，他曲折的穿过了悬崖峭壁，冲倒了层沙积土，挟卷着滚滚的沙石，快乐勇敢地流走，一路上他享受着他所遭遇的一切，有时候他遇到巉岩前阻，他愤激地奔腾了起来，怒吼着，回旋着，前波后浪地起伏催逼，直到冲倒了这危崖，他才心平气和地一泻千里。	Hard 82 84 巉岩
他的面孔黄里带白，瘦得教人担心，好像大病新愈的人，但是精神很好，没有一点颓唐的样子。	Normal 16 18 好像
他打算先喝点热水，然后再开始向船走去，他已经料到这是一段可怕的路程。	Normal 31 33 路程
她递给我一株野菊花，花边已经打卷了，花朵耷拉下来。	Normal 10 12 花边
这个案子的“罪犯”呢，坐在人群中央的地上，前腿劈开，浑身发抖——原来是一条白毛的小猎狗，脸尖尖的，背上有块黄斑。	Normal 21 23 前腿
现在将错就错，安坐不动。	Normal 0 2 现在
许多同学都跟着一起背起来：“人有悲欢离合，月有阴晴圆缺，此事古难全。”	Hard 16 20 悲欢离合
按照邵飘萍的要求，记者应当时刻生活在角色中，闲谈时，众人皆“醉”，唯我独醒，“新闻脑”始终紧张活动，一旦提笔行文，则又“状若木鸡，静穆如处子”，倾注整个身心。	Normal 18 20 角色
那两个学生——磨房的若望和罗班·普斯潘——尖着嗓子哼起那段古老的民间回旋曲的叠句来了：	Normal 23 25 嗓子
麦田整整齐齐摆在辽阔的大地上，仿佛一块块耀眼的黄金。	Normal 12 14 地上
蒙娜丽莎那微抿的双唇，微挑的嘴角，好像有话要跟你说。	Normal 17 19 好像
国际互联网上的内容非常丰富，各种知识、各类信息无所不有。	Normal 9 11 非常
这时候上来一道汤，汤里的冬笋、蘑菇、荸荠等拼成各种图案，简直就是精美的工艺品。	Hard 18 20 荸荠
在由于恐怖而变得混乱的意识里，却出奇清晰地反映出岸上那个追赶我的人的残酷笑声。	Normal 18 20 清晰
往日同游的朋友，虽然已经云散，然而鱼翅是不可不吃的，即使只有我一个……	Hard 12 14 云散
全中国的读书人，大概从唐朝以来，命运中就注定了应读一篇《桃花源记》，因此把桃源当成一个洞天福地。	Normal 4 7 读书人
后来，鲲变成了一只大鸟，名字叫作鹏。	Hard 3 4 鲲
一群麋鹿悄无声息地向水塘边走去。	Hard 2 4 麋鹿
写到这里，不由吐了吐舌头，因为北大老师们的紧像，也一视同仁地留在了我的写生画册上：有的绅士风度，有的和蔼可亲，这个怪癖，那个潇洒，或手谈笑风生间“樯橹灰飞烟灭”，或于古朴凝重之中‘形成另一番风格……	Hard 73 79 樯橹灰飞烟灭
少焉，月出寒阴，微明散布石上，松声倏然自万壑来，客皆悚视寂，觉境愈清，思愈远。	Hard 8 14 微明散布石上
（《礼记・学记》）“乐群”这两个字很能代表中华文化的特点。	Hard 10 12 乐群
小熊捋下一片小椿树叶。	Hard 6 10 小椿树叶
似乎得胜之后，便可以动手行窃了。	Normal 0 2 似乎
又有一次，这只鸟的恶作剧把我吓了一大跳。	Normal 14 15 吓
庚子年（一九零零）前后，四川连年旱灾，很多的农民饥饿、破产，不得不成群结队地去“吃大户”。	Normal 24 26 饥饿
它们将短硬的喙像北方农妇在缸沿砺刀那样，在枝上反复擦拭。	Hard 15 17 砺刀
滔滔大河突然转了一个直角，令人惊叹不已，教人不可思议。	Normal 4 6 突然
他知道他终于给打败了，而且一点补救的办法也没有，于是他走回船梢，发现舵把的断成有缺口的一头还可以安在舵的榫头上，让他凑合着掌舵。	Hard 52 54 榫头
至于雨敲在鳞鳞千瓣的瓦上，由远而近，轻轻重重轻轻，夹着一股股的细流沿瓦槽与屋檐潺潺泻下，各种敲击音与滑音密织成网，谁的千指百指在按摩耳轮。	Hard 66 68 耳轮
细娃们都像喝了碗凉水，心里格外舒畅，一齐喊叫道：“该背时！	Hard 0 2 细娃
一种是“海溜”，最大，色黑，叫声洪亮。	Hard 4 6 海溜
我们把新怀疑主义带进了所有的课堂，给那些不习惯质疑的老师带来了烦恼。	Hard 4 8 怀疑主义
它也可能是比较急促的号子，那是纤夫在吼，他们拉纤逆流而上，如果拉的是小木船，也许就只五六个人，如果拉的是扬着横帆的大船过急滩，那就要两百来人。	Normal 64 66 就要
我家只有一个忙月，忙不过来，他便对父亲说，可以叫他的儿子闰土来管祭器的。	Normal 26 28 儿子
他们都不以家乡为终点，就像三峡的水拼着全力流注四方。	Normal 8 10 终点
更羸说：“请让我试一下。”	Hard 0 2 更羸
他把每件事和每个人都考虑到了，面对惊慌失措的众人，他镇定自若，仿佛他不是给人而是在给灾难下达命令，就连失事的船舶似乎也听从他的调遣。	Normal 59 61 听从
这些作品虽成过去，却仍虎虎有神，正如唐人郭震所形容的：“虽复尘埋无所用，犹能夜夜气冲天。”	Hard 36 43 犹能夜夜气冲天
这一道工序技术难度很高，窑内温度始终要保持在800℃～940℃，才能使陶俑各部分受热均匀，烧出后“视之色如青石，扣之声如磬玉”。	Hard 49 55 视之色如青石
张乡绅攀谈道：“世先生同在桑梓，一向有失亲近。”	Hard 13 15 桑梓
心中想着，忽见丫鬟话未报完，已进来了一位年轻的公子：头上戴着束发嵌宝紫金冠，齐眉勒着二龙抢珠金抹额；穿一件二色金百蝶穿花大红箭袖，束着五彩丝攒花结长穗宫绦，外罩石青起花八团倭缎排穗褂；登着青缎粉底小朝靴。	Hard 70 71 攒
刘伯承假装没有看见，只等他们快要撵拢身边，才一个纵步跳进麻柳林。	Hard 16 18 撵拢
壶口瀑布位于山西吉县，黄河干流流经晋陕峡谷，两岸束狭如“壶口”，水流至此，声若雷鸣，波涛翻滚，烟雾迷漫，令人目眩神荡。	Normal 13 15 干流
鲁达看时，只见郑屠挺在地下，口里只有出的气，没了入的气，动弹不得。	Hard 10 13 在地下
早饭之后，她便到镇的西头的土地庙里去求捐门槛，庙祝起初执意不允许，直到她急得流泪，才勉强答应了。	Hard 20 22 门槛
几十年前，我小的时候，老鸹是北京一景。	Hard 11 13 老鸹
翻耕的犁铧激起一行行土浪，上升到地表的土壤形成整齐而粗大的线条，这些斑纹，是即将受孕的标记。	Hard 3 5 犁铧
它行程5464千米，流经9个省、自治区，汇聚了渭河、泾河等几十条主要支流和上千条溪川，流域面积达75万多平方千米，是中国第二长河，世界第五大河。	Normal 20 22 汇聚
孔子亦说：“君子和而不同。”	Hard 8 12 和而不同
满园春色关不住	Hard 0 4 满园春色
老余说：“可能是一位守山护林的老人。”	Normal 15 17 老人
因此步步留心，时时在意，不肯轻易多说一句话，多行一步路，惟恐被人耻笑了他去。	Normal 14 16 轻易
她梦想那些宽敞的客厅，那里张挂着古式的壁衣，陈设着精巧的木器，珍奇的古玩。	Hard 19 21 壁衣
大熊猫如今分布地域十分狭窄，仅见于我国四川省的岷山、邛崃山和大小凉山，甘肃省的南缘和陕西省秦岭南麓等海拔2000～3500米的崇山峻岭。	Hard 47 49 南麓
藕荷色的小蝴蝶，背着圆壳的小蜗牛，嗡嗡的蜜蜂，甚至于水里每夜乱唱的青蛙，在花丛中闪烁的萤虫，都是极温柔，极其孩子气的。	Hard 0 3 藕荷色
所以像王思任写晚霞那样感性恣纵的杰作，在明清的文坛简直不作第二人想。	Hard 13 15 恣纵
大大小小几何形的麦田将原野均匀分割，种粒的全部能量转化为垄间破土而出的禾苗，它们将在秋天成熟，连绵不绝，设下朴素的宴席——握住镰柄的农民融入麦芒闪耀的金光里，积年劳作使他们的掌心磨砺出粗厚的老趼。	Hard 95 97 老趼
忽然，我看到一个衣衫褴褛的中年人疲软地靠在一堵墙上，他的眼睛闭着，黧黑的脸扭曲如一截枯根，不知在忍受什么。	Hard 33 35 黧黑
一道阳光照醒了他，他慢腾腾地起来，准备到部里去。	Normal 2 4 阳光
现在，人们用“舍本逐末”来比喻做事不抓住主要问题，而专顺细枝末节。	Hard 26 28 专顺
这位宋朝的隐士林和靖，妻梅子鹤，终老是乡，范仲淹曾赞美他“片心高与月徘徊，岂为千钟下钓台。	Hard 37 44 岂为千钟下钓台
朱砂峰被吞没；桃花峰到了波涛底；耕云峰成了一座小岛；整鱼峰游泳在雪浪花间。	Normal 0 2 朱砂
观众团团围坐，所有的剧情靠“雄谢巴”的解说和艺人们的说唱来描述。	Hard 14 17 雄谢巴
却说那大圣已至灌江口，摇身一变，变作二郎爷爷的模样，按下云头，径入庙里，鬼判不能相认，一个个磕头迎接。	Normal 20 22 爷爷
她还会扎针、拔罐子、接生、接骨、看红伤。	Hard 16 19 看红伤
“没有人应该因镭致富，镭是一种元素，它是属于全世界的。”	Hard 7 8 镭
一个参观者惊惧万分，张大了嘴巴，他想叫，但是叫不出来——原来，在女牢房，他看到了一些盒子。	Normal 42 44 盒子
金龟子的折扇，跟天牛长长的须角、锹甲的铁锹般的上颚一样，都是发育成熟可以求偶的标志，只是外形各不相同而已。	Hard 23 25 上颚
所以像王思任写晚霞那样感性恣纵的杰作，在明清的文坛简直不作第二人想。	Normal 7 9 晚霞
正是这大面积的森林，才使千岛湖更加秀美，成为新兴的旅游胜地。	Normal 17 19 秀美
上午我在浴室的窗子上发现一只大孔雀蝶。	Normal 7 9 窗子
工地上没有抽水机，詹天佑就带头挑着水桶去排去。	Normal 17 19 水桶
这时他才发现，那不是一块黑板，而是一辆马车车厢的后壁。	Hard 24 26 后壁
爸没说什么，打开了手中的包袱，拿出来的是我的花夹袄。	Normal 6 8 打开
秦俑的制作充分体现了中国古代发达的科学技术，令许多国外的科学史家惊叹不已。	Hard 0 2 秦俑
实则，邵飘萍反对奉系军阀，在《京报》讽刺张作霖“一世之枭亲离众叛”，张学良忠孝两难，且退回张作霖三十万“封口费”，自言“张作霖出三十万买我，这种钱我不要，枪毙我也不要！”	Normal 0 2 实则
每当眼泪涌上来的时候，他总是一忍再忍，把那泪珠儿拦在眼眶里打转。	Normal 2 4 眼泪
渔夫一边把胆瓶挪近岸边，准备扔到海里去，一边说，“我要把你扔到海里，你说你在海里已经呆过一千八百年，这一回我非叫你在海里呆一辈子不可。	Hard 5 7 胆瓶
中华鲟生活在江河里，最大的可以长到五百千克重。	Hard 0 3 中华鲟
贾母急的搂了宝玉道：“孽障！	Hard 11 13 孽障
但在我看来，这一切不过是堕落，如果你愿意的话，也可以说是一时的离经叛道，总还是必须回到纯朴派和明晰派中来的，正如人们终归还是吃那使他获得营养而永不会使他厌腻的日常必吃的面包。	Normal 43 45 纯朴
无疑，这张脸平淡无奇，障碍重重，没法弥补，不是传播智慧的庙堂，而是禁锢思想的囚牢；这张脸蒙昧阴沉，郁郁寡欢，丑陋可憎。	Normal 6 10 平淡无奇
我以为邓稼先如果是美国人，不可能成功地领导美国原子弹工程;奥本海默如果是中国人，也不可能成功地领导中国原子弹工程。	Normal 23 26 原子弹
歌乐山下悟道	Hard 4 6 悟道
来到这座城市，展现在救援队员面前的是一片悲惨景象：房倒屋塌，失去亲人的大人、孩子在哭泣，空气中弥漫着尸体腐烂后荼发的臭气。	Normal 41 43 哭泣
难道我这个人将以荷而传吗？	Hard 7 11 以荷而传
一位中国诗人说：“言有尽而意无穷。”	Normal 4 6 诗人
两年前，他被拐卖给一个马戏班，戏班的人将他带到了国外。	Normal 15 17 戏班
他攀上去之后，其他几个年轻人也一一上去，终于将塔刹的各部尺寸、做法测绘下来。	Hard 23 25 塔刹
统领、他的侄子、为枪手发令的中尉、一个医生和一个牧师已经站在院中了，他们一本正经地往前走着，看到牛虻含笑的眼睛中光芒四射的蔑视，他们都有些局促不安。	Hard 48 50 牛虻
因这年秋尽冬初，天气冷将上来，家中冬事未办，狗儿未免心中烦躁，吃了几杯闷酒，在家里闲寻气恼，刘氏不敢顶撞。	Hard 10 14 冷将上来
这下可闯了大祸，不周山是支撑天的柱子，柱子一倒，天塌地陷，日月星辰向西移去。	Normal 16 18 柱子
那暗呜变色，叱咤的风云又汇聚起来。	Normal 14 16 起来
大家吵吵嚷嚷，兴高采烈，准备看伽利略出洋相，对他的人品宣判死刑。	Normal 25 27 人品
因此，谁如果要鉴赏我国的园林，苏州园林就不该错过。	Normal 22 24 错过
一方的异彩，揭去了满天的睡意，唤醒了四隅的明霞——光明的神驹，在热奋地驰骋。	Hard 18 20 四隅
他决定要“格”院子里的竹子。	Hard 5 6 格
不料叫圩子上一个万员外看中了，死逼着龙家父子连夜替他赶造一条大船，准备把当地粮米都搜刮起来，到合浦去换珠子，好献给皇帝买官做。	Hard 3 5 圩子
不更事的勇敢的少年，往往敢于给人解决疑问，选定医生，万一结果不佳，大抵反成了怨府，然而一用这说不清来作结束，便事事逍遥自在了。	Hard 33 35 大抵
他下车伊始就拿出一部具有决定意义的作品，使自己跻身于大师的行列。	Hard 23 25 跻身
到武夷山游览，可以爬山，也可以乘坐古朴的竹筏，在九曲溪上绕着山峰静静地、缓缓地、曲曲弯弯地漂行。	Normal 15 17 乘坐
那少年走到我跟前，诚恳地说：“夫人，您买一个吧！”	Normal 6 8 跟前
我们并不希冀有传世之作。	Normal 0 2 我们
然而，这种爱看戏的嗜好，很快地引起了她爱打扮的需要。	Hard 9 11 嗜好
当时我已经处于半靠边的状态，傍晚我们在院子里乘凉，孩子们都劝我把包弟送走，我请我的大妹妹设法。	Hard 8 10 靠边
另一位先生听得厌烦，把嘴里的香烟屁股扔到街心，睁大了眼睛说：“你们嫌价钱低，不要粜好了。	Hard 40 41 粜
在这样的天地中独个儿行走，巨人也变成了侏儒。	Normal 7 10 独个儿
雨来了，雨来的时候瓦这么说，一片瓦说，千亿片瓦说，轻轻地奏吧沉沉地弹，徐徐地叩吧挞挞地打，间间歇歇敲一个雨季，即兴演奏从惊蛰到清明，在零落的坟上冷冷奏挽歌，一片瓦吟千亿片瓦吟。	Hard 40 42 挞挞
将军既帝室之胄，信义著于四海，总揽英雄，思贤如渴，若跨有荆、益，保其岩阻，西和诸戎，南抚彝、越，外结孙权，内修政理；待天下有变，则命一上将将荆州之兵以向宛洛，将军身率益州之众以出秦川，百姓有不箪食壶浆以迎将军者乎？	Hard 3 7 帝室之胄
此时，《歌唱祖国》的豪迈旋律以柔板的方式表现出来，令人心潮澎湃。	Hard 15 17 柔板
他开始跑起来，将外套、皮靴、水袋与帽子一件一件扔掉，只留下铁锨做拐杖。	Hard 29 31 铁锨
想到几十年前若是遇到这种情形，寿镜吾老先生该会喊了吧：“人都到哪里去了！”	Normal 0 2 想到
那里的椴树高大而阴凉，	Normal 8 10 阴凉
船在水面上飞快地行驶。	Normal 5 7 飞快
大部分土楼有两三百年甚至五六百年的历史，经受无数次地震振动、风雨侵蚀以及炮火攻击而安然无恙，显示了传统建筑文化的魅力。	Normal 27 29 振动
阿拉伯人是对沙漠广有经验的民族，阿拉伯语中称这一现象为“魔鬼的海”。	Hard 28 30 魔鬼
我有一时，曾经屡次忆起儿时在故乡所吃的蔬果：菱角、罗汉豆、茭白、香瓜。	Hard 29 31 茭白
一到河边，乘船的乘船，坐竹排的坐竹排，基至连马都用上了，不会游冰的就着马尾巴。	Normal 16 18 竹排
尽管他勇往直前，挥舞双臂，但是，身体顶不住地下沉，还没有等到羽毛着火，就大叫一声，一个倒栽葱，跌入了大海。	Normal 22 24 下沉
在茫茫人世中，人们争名于朝，争利于市，哪里有闲心来关怀一棵古藤的生死呢？	Normal 32 34 生死
有一种人，读书虽然不多，但他对于人情事理，都很通达，凭借经验，运用心得，“官知止而神欲行，依乎天理，批大郤，导大窾”。	Hard 50 53 批大郤
然而，一看到玻璃窗内成堆的头发和婴儿的鞋子，一看到用以关押被判处绞刑的死囚的牢房时，他们就不由自主地停下脚步，浑身发抖。	Normal 35 37 死囚
人们根据这个神话，给彩虹起了个美丽的名字，称它为“红霞瑞马”，它是壶口瀑布的一大奇景。	Hard 25 29 红霞瑞马
这藤野老师，据说是穿衣服太模胡了，有时竟会忘记带领结；冬天是一件旧外套，寒颤颤的，有一回上火车去，致使管车的疑心他是扒手，叫车里的客人大家小心些。	Normal 69 71 小心
但是，持对立观点的皮埃尔并不甘于失败。	Normal 16 18 失败
肖邦就是这样带着亡国之恨在异国他乡与世长辞了。	Normal 2 4 就是
酒家道：“只有熟牛肉。”	Normal 8 10 牛肉
一种生意盎然之美，一种随处生春之美，读久了就觉得生命很亮丽，很新鲜活泼有力。	Hard 11 15 随处生春
多少年来，这两个主人公一直被人们当作神童传颂，并且成为我国教育儿童、开发智慧的典范。	Normal 18 20 神童
深褐色的海带，漂动在碧波里；一片片绿色的、红色的石花菜，生长在海底岩石上……	Normal 4 6 海带
这些美，作为设计师的追求也都无可厚非。	Normal 6 9 设计师
它或象征着幸福,或隐喻着爱情,或呼唤着友谊,或赞美着生命；有的是喜庆的标志,有的是智慧的图腾；它烘托着欢乐,燃烧着热情……	Normal 32 34 喜庆
在最寒冷的日子里，有个年轻女子拖一具小棺材在街头踉跄，小棺材里躺着她冻馁而亡的孩子。	Hard 34 38 冻馁而亡
老都管道：“你们不要怨怅，巴到东京时，我自赏你。”	Hard 13 14 巴
真要勉用文字来着色，也不过像谢灵运的一些名句“云日相晕映，空水共澄鲜”或是“出谷日尚早，入舟阳已微。	Hard 44 49 入舟阳已微
就这样，鹬蚌相持着，谁也不让谁。	Hard 4 8 鹬蚌相持
水正在结冰，人们可以听到冰块的碎裂声。	Normal 3 5 结冰
但是对于黄翅飞蝗泥蜂来说，这一切还不足以使猎物无法伤害自己，它还需要紧紧勒住猎物，使之丝毫不能动弹，以便螫针能把毒汁注入要刺的地方；也许正是为了使腹部无法动弹，黄翅飞蝗泥蜂才咬住猎物腹部末端的肉。	Hard 52 54 螫针
真君撞进门，大圣见了，现出本相道：“郎君不消嚷，庙宇已姓孙了。”	Hard 20 23 不消嚷
月色豫胧的夜半，有一二猎夫，会效仿麂子的嘶声，往往登高一呼，麂子便成群地走来。……	Hard 17 19 麂子
海张五在那边，隔着两丈远就看出捏的是他。	Normal 4 6 那边
一九四五年，我们战胜了日本强盗，我从延安回来，在碛口地方，跳到黄河里去洗了一个澡，一时大意，奔腾的黄水，冲走了我的全部衣物，也冲走了那双袜子。	Hard 24 26 碛口
酒保唱了喏，认得是鲁提辖，便道：“提辖官人，打多少酒？”	Normal 6 8 认得
李白诗曰：“东风已绿瀛洲草，紫殿红楼觉春好。”	Hard 10 13 瀛洲草
但是，这是符合历史事实的虚构，是符合梁思成思想逻辑的合理想象。	Normal 28 30 想象
杨志又问道：“你等莫不是歹人”那七人道：“你颠倒问，我等是小本经纪，那里有钱与你。”	Hard 22 24 颠倒
每天晚饭后，妈妈都要不厌其烦地陪我练习。	Normal 2 4 晚饭
一排排搭石，任人走，任人踏，它们联结着故乡的小路，也联结着乡亲们美好的情感。	Normal 19 21 故乡
梁中书道：“上年费了十万贯收买金珠宝贝，送上东京去，只因用人不着，半路被贼人劫将去了，至今无获。	Hard 11 13 万贯
《千家诗》中很大一部分诗歌歌咏祖国风物，按春夏秋冬时序编排，打开书往下念，四季风光就活生生地展现在眼前：“成紫千红总是春”，“春城无处不飞花”；“绿树阴浓夏日长”，“五月榴花照眼明”；“青女素娥俱耐冷，月中霜里斗婵娟”；“梅雪争春未肯降，骚人搁笔费评章”……	Hard 93 100 青女素娥俱耐冷
一头老母牛正在破墙边晒太阳，东郭先生就作了一个揖请教它。	Normal 3 5 母牛
顿时，一种不可名状的恐惧感紧紧地攫住了我。	Hard 16 17 攫
将军既帝室之胄，信义著于四海，总揽英雄，思贤如渴，若跨有荆、益，保其岩阻，西和诸戎，南抚彝、越，外结孙权，内修政理；待天下有变，则命一上将将荆州之兵以向宛洛，将军身率益州之众以出秦川，百姓有不箪食壶浆以迎将军者乎？	Hard 44 45 彝
然而，从哥白尼③时代开始，我们就被降级为绕着一颗非常平凡的恒星公转的一颗行星，而该恒星又是绕着我们看得见的不过是一千亿个星系中的一个典型星系的外边缘公转。	Hard 31 33 公转
临窗大炕上铺着猩红洋罽，正面设着大红金钱蟒靠背，石青金钱蟒引枕，秋香色金钱蟒大条褥。	Hard 9 11 洋罽
比较早的有葡萄、苜蓿、茉莉、苹果、菠菜等等，近代的像咖啡、可可、柠檬、雪茄、巧克力、冰淇淋、白兰地、啤酒、卡片、沙发、扑克、哔叽、尼龙、法兰绒、道林纸、芭蕾舞等等，都是极常见的。	Hard 62 64 哔叽
忽见一人，容貌轩昂，丰姿俊爽，头戴逍遥巾，身穿皂布袍，杖藜从山僻小路而来。	Normal 21 23 身穿
我从开着的窗子望进去，看见同学们都在自己的座位上了；韩麦尔先生呢，踱来踱去，胳膊底下夹着那怕人的铁戒尺。	Hard 49 51 戒尺
学问是寸积铢累而来的，常是各有疆域独自为政的。	Normal 11 13 常是
因为它长得粗壮结实，样子也不大好看，还特别在前面加一个“侉”字，叫做“侉叫蛐子”。	Hard 28 29 侉
可是，她拗不过老头子，也怕伤了儿子的心，不乐意也只得同意了。	Hard 4 5 拗
“你等着吧，总有一天我要把你从这儿撵走……”	Hard 17 19 撵走
这媳妇长得很好看，高高的鼻梁，弯弯的眉，额前一溜蓬松松的留海。	Hard 22 24 一溜
当我们从生物的世界到人类的社会，一以贯之地看待寄生策略的时候，便可望获得一种不卑不亢、不瘟不火、不喜不哀的态度。	Normal 53 55 态度
磨房很破，天一黑阴沉沉的，阴雨天风一吹里外怪响。	Normal 16 19 风一吹
这种新物质的放射性极强，极少量的镭散布在矿石中，就是一些触目的现象的来源，很容易观察或测量。	Hard 16 17 镭
还有的，因为中了暑，或是发痧，走着走着，一头栽到地上，永不起来。	Hard 12 14 发痧
他的创作是如此博大精深，又是如此有意识地自成一体，因此，可以毫无愧色地说，他的艺术是世界文化的不容置疑的组成部分。	Normal 52 56 组成部分
就这样他们还是唱着激昂而热切的号子，那汹涌澎湃的江水号子。	Normal 15 17 号子
由于受潮水的顶托，还有一部分泥沙回淤在入海口，形成了坚硬的河岗。	Normal 26 28 坚硬
父亲曾摸着其中一块的那个小凹凼惊异地说，想不到这么深了，怪不得我的烟枪已经用旧了三根呢。	Hard 12 15 小凹凼
次日早起五更，在府里把担仗都摆在厅前，老都管和两个虞候又将一小担财帛，共十一担，拣了十一个壮健的厢禁军，都做脚夫打扮。	Hard 48 51 厢禁军
这样布置后，它打开了它的云库，拨给这区域的，有倏来倏去的云，扑朔迷离的雾，绮丽多彩的霞光，雪浪滚滚的云海。	Hard 23 27 倏来倏去
至于视觉经验，也都表现得很有动感：写荷花迎风则“红披绿偃，摇荡葳蕤”，写微风拂水则“细生鳞甲”，写流萤则“（幽火）班班，若骇若惊，奄忽去来”，写山则“森森欲下搏人”。	Hard 60 64 若骇若惊
画中的“孙阳店”、“脚店”等，与《东京梦华录》中所记得“曹婆婆肉饼”“正店七十二户······其余皆谓之脚店”等，无有不符。	Normal 41 42 ·
至发电时止，我东路各军已大部渡过南岸，余部23日可以渡完。	Normal 16 18 南岸
“蜀道之难难于上青天”，“天姥连天向天横”，这个“上青天”、“向天横”都是直上直下将人的生命与宇宙生命相贯通。	Hard 13 20 天姥连天向天横
而笼子里换上了一只小豹，即使感觉最迟钝的人看到在弃置了如此长时间的笼子里，这只凶猛的野兽不停地蹦来跳去，他也会感到赏心悦目，心旷神怡。	Normal 1 3 笼子
此时此刻，我耳边又回响着充满墨香的书声，快乐童真的歌声，尽情嬉闹的笑声，诲人不倦的心声……	Normal 9 11 回响
我看见过许多刚刚失去了狼的山的样子，看见南面的山坡由于新出现的弯弯曲曲的鹿径而变得皱皱巴巴。	Normal 20 22 南面
李白诗曰：“东风已绿瀛洲草，紫殿红楼觉春好。”	Hard 14 21 紫殿红楼觉春好
──如果美是专指“婆娑”或“横斜逸出”之类而言，那么白杨树算不得树中的好女子；但是它却是伟岸，正直，朴质，严肃，也不缺乏温和，更不用提它的坚强不屈与挺拔，它是树中的伟丈夫！	Normal 47 49 正直
广场北面乾清门以内叫“内廷”，是皇帝和后妃们起居生活的地方，主要建筑有乾清宫、交泰殿、坤宁宫和东六宫西六宫。	Normal 2 4 北面
史可法大骂气绝而死。	Normal 3 5 大骂
我手里拿着戒尺站住等他。	Hard 5 7 戒尺
走进我家的院子，你会看到坐北朝南的一排新房，房檩、房柱都是一色儿新的，散发着树脂的香味。	Hard 22 24 房檩
一忽儿，四处都响了起来，你呼我应，此起彼落。	Normal 4 6 四处
他非常愿意彻夜不睡，同这样的看守共度通宵；他愿意跟他们逗趣戏谑，给他们讲他漂泊生涯的故事，然后又悉心倾听他们的趣闻，目的只有一个：使他们保持清醒，以便让他们始终看清，他在笼子里什么吃的东西也没有，让他们知道，他们之中谁也比不上他的忍饿本领。	Hard 27 31 逗趣戏谑
周副主席那浓浓的胡须绽开来，宽慰地笑了。	Normal 10 12 绽开
“准是那冰棍儿变质了！”	Normal 4 7 冰棍儿
一天，川川和磊磊在山上玩，看见一个勘探队员正趴在一块大石头上，聚精会神地看着什么。	Normal 13 15 看见
诗人的诗句，也许不尽是在江南所写，而做这几句诗的诗人，也许不尽是江南人，但借了这几句诗来描写江南的雪景，岂不直截了当，比我这一枝愚劣的笔所写的散文更美丽得多？	Normal 3 5 诗句
现在,陕西省洋县已被列入自然保护区,成群的朱鹮正在那里快乐地生活着。	Hard 21 23 朱鹮
它们过分热情地扑向过分冷漠的荒丘，不管人家愿不愿意，就去亲吻就去拥抱，热烈疯狂，缱绻缠绵，完全是一种自己的方式。	Hard 40 44 缱绻缠绵
有一次武委会训练村干部，恰巧小二黑发疟疾没有去。	Hard 18 20 疟疾
例如《诗经·鲁颂》的《駉》这一首诗里提到马的名称就有16种：“驈”(身子黑而胯下白的)，“皇”(黄白相间的)，“骊”(纯黑色的)，“黄”(黄而杂红的)，“骓”(青白杂的)，“駓”(黄白杂的)，“騂”(红黄色的)，“骐”(青黑成纹像棋道的)，“驒”(青黑色而有斑像鱼鳞的)，“骆”(白马黑鬃)，“駵”(红马黑鬃)，“雒”(黑马白鬃)，“駰”(灰色有杂毛的)，“騢”(红白杂毛的)，“驔”(小腿长白毛的)，“鱼”(两眼旁边毛色白的)。	Hard 11 12 駉
魁梧黧黑的渔夫拖着湿淋淋的被撕破了的鱼网，一边走进来，一边说：“嘿，我回来啦，桑娜！”	Hard 0 4 魁梧黧黑
翻开一部《辞源》或《辞海》，金木水火土，各成世界，而一入“雨”部，古神州的天颜千变万化，便悉在望中，美丽的霜雪云霞，骇人的雷电霹雹，展露的无非是神的好脾气与坏脾气，气象台百读不厌门外汉百思不解的百科全书。	Hard 53 57 霜雪云霞
“诸位爱卿，”他颓丧地向他的四位枢密参赞说道，“在寡人登基三十周年纪念的今天，竟有歹徒将一封黑信投进了寡人所乘的马车。	Hard 16 20 枢密参赞
小獾已经做成了三个小板凳。	Hard 1 2 獾
那是一座空气流通、阳光充足、有东南两面大窗的漂亮房子。	Normal 17 19 两面
九色鹿生性忠厚，心中还有点怀疑白鸟的警告，没来得及躲避，就被千军万马重重包围住了。	Normal 13 15 怀疑
剃头铺子简直就是当地的新闻中心、舆论阵地，谁家的兴衰荣辱，是非曲直都可以从那里明访暗察；若说有能够反映民意的机构，我以为剃头铺便是。	Normal 4 6 简直
周恩来声音从容柔和：“过澧水不算过长江。	Hard 12 14 澧水
巨大的漕船，舳舻相接，忙碌的船工从停泊在河边的粮船上卸下沉重的粮包，纤夫们拖着船，逆水行驶，一片繁忙景象。	Hard 6 10 舳舻相接
终点近了，近了，突然脚下一滑，我失去了知觉。	Normal 0 2 终点
房内有石锅、石灶、石碗、石盆、石床、石凳。	Normal 3 5 石锅
有弗学，学之弗能弗措也；有弗问，问之弗知弗措也；有弗思，思之弗得弗措也；有弗辨，辨之弗明弗措也；有弗行，行之弗笃弗措也。	Hard 40 47 辨之弗明弗措也
甚么人看了我这个记载，若神往于香草香花的沅州，居然从桃源包了小船，过沅州去，希望实地研究解决《楚辞》上几个草木问题，到了沅州南门城边，也许无意中会一眼瞥见城门上有一片触目黑色。	Normal 62 64 南门
李白诗云“燕山雪花大如席”，不知有几万、几十万朵雪花才能黏连成一片席那么大呢！	Hard 9 12 大如席
我想，不止是这江面上众多的升帆的货船和鸣笛的汽轮，那来往穿梭的舢板和驳船，不止是停泊在江心的钻探船，不止是下关码头两旁长长的仓库、堆栈和高楼，使你的心好像黎明一般的欢畅，青春一般的欢愉。	Normal 90 92 欢愉
城中军营里，税关局长公馆，河街上一些大字号，莫不预先截老毛竹筒，或镂空棕榈树根株，用洞硝拌和磺炭钢砂，一千槌八百槌把烟火做好。	Hard 53 54 槌
不久，英国政府采纳了罗兰希尔的建议，批准了世界上第一种邮资凭证——邮票，规定信件不超过半盎司（相当于14克），收费1便士。	Hard 44 46 盎司
龙门是黄河上的一个古老的渡口，是陝西、山西两省的交通要道。	Hard 12 14 渡口
我想到了当年陪同梁思成勘探木塔的年轻学者莫宗江先生后来的回忆：他们爬到了塔顶，但塔刹还有十多米高，除了几根铁索外，没有任何可供攀岩的东西。	Normal 28 30 回忆
大熊猫如今分布地域十分狭窄，仅见于我国四川省的岷山、邛崃山和大小凉山，甘肃省的南缘和陕西省秦岭南麓等海拔2000～3500米的崇山峻岭。	Hard 26 29 邛崃山
时云长在侧曰：“某闻管仲、乐毅乃春秋、战国名人，功盖寰宇；孔明自比此二人，毋乃太过？”	Hard 37 41 毋乃太过
酒保唱了喏，认得是鲁提辖，便道：“提辖官人，打多少酒？”	Hard 2 3 唱
这也是千古名句，可是这里的“高树多悲风”却并没有落叶的形象，而“寒风扫高木”则显然是落叶的景况了。	Normal 39 41 显然
有一只老斑羚不知是老眼昏花没测准距离，还是故意要逞能，竟退后十几步一阵快速助跑奋力起跳，想跳过六米宽的山涧，结果在离对面山峰还有一米多的空中哀咩一声，像颗流星似的笔直坠落下去，好一会儿，悬崖下才传来扑通的落水声。	Normal 99 101 扑通
细娃们都像喝了碗凉水，心里格外舒畅，一齐喊叫道：“该背时！	Hard 26 28 背时
幽兰吐秀乔林下，仍自盘根众草傍。	Hard 0 4 幽兰吐秀
茎上长叶柄的地方，反面伸出枝状的六七根细丝，每根细丝像蜗牛的触角。	Normal 9 11 反面
一天，正值黄梅时节，天气闷热，王冕放牛累了，便在绿草地上坐着。	Hard 5 9 黄梅时节
人何必增添末路的人的苦恼，为她起见，不如说有罢。	Normal 3 5 增添
到晚饭时候，外祖母也终于觉察了，并且说我应当不高兴，他们太怠慢，是待客的礼数里所从来没有的。	Normal 6 9 外祖母
例如打球有利于腰背，射箭可扩胸利肺，散步则有助于消化，骑术使人反应敏捷，等等。	Normal 10 12 射箭
有一天，叙利奥对父亲说：“爸爸，我来替您写吧，我能写得和您一样好呢！”	Normal 13 15 爸爸
说罢，他把那支从敌人手里夺来的枪砸碎了，然后走向悬崖，像每次发起冲锋一样，第一个纵身跳下深谷。	Normal 16 18 砸碎
要是暂时经过苦难，重新克服了困境，就会说：“两岸猿声啼不住，轻舟已过万重山！”	Normal 6 8 苦难
忽见一人，容貌轩昂，丰姿俊爽，头戴逍遥巾，身穿皂布袍，杖藜从山僻小路而来。	Hard 27 29 杖藜
一会儿,他们就来到村里,小光的爸爸接待了他们。	Normal 0 3 一会儿
在日式的古屋里听雨，听四月，霏霏不绝的黄梅雨，朝夕不断，旬月绵延，湿黏黏的苔藓从石阶下一直侵到舌底，心底。	Normal 50 52 心底
外国一些城市所谓的“围墙”，或是雅致的栏杆，镂空的铁丝网，或是生机盎然的“绿色围墙”：建筑物在“围墙”内若隐若现，既不损坏城市的环境整体美，也不妨碍市民的视野空间。	Normal 25 28 铁丝网
和乌鸦很相像的那种怪样子的墨鸭，整排地停在舷上，它们的脚是用绳子吊住了的，下水捕鱼，起水的时候船户就在它的颈子上轻轻地一挤！	Hard 21 22 舷
若果他那文章还值得称引，我们尚可以就“沅有芷兮澧有兰”与“乘舲上沅”这些话，估想他当年或许就坐了这种小船，溯流而上，到过出产香草香花的沅州。	Hard 29 33 乘舲上沅
这些，老兄，倒没什么，我跟他不论怎么总可以过下去的，只是我的心震荡得厉害，得换一个活塞了……	Normal 7 10 没什么
它们好像怕强烈的日光，白天常常躲在窝里歇凉，只在树枝被风刮得乱摇晃的时候，它们才到地面上来。	Normal 24 26 树枝
他还建立了非常美的科学的宇宙模型。	Normal 12 14 宇宙
在阴森森的一片寂寞之中，始终只有这么几个人在行走，他们的英雄气概不能不令人钦佩。	Normal 22 24 行走
但钱老本人却心境平和，把些世俗之人追求的金钱、地位看得比清水还淡。	Normal 20 22 金钱
金龟子的折扇，跟天牛长长的须角、锹甲的铁锹般的上颚一样，都是发育成熟可以求偶的标志，只是外形各不相同而已。	Hard 19 21 铁锹
我眺望四周，一片茫无边际的蔚蓝的海，无数波浪闪耀着金鳞；头上，也是这样茫无边际，这样蔚蓝的海——在那儿，温柔的太阳在运行着，宛然在微笑。	Hard 62 64 宛然
我梦想有一天，亚拉巴马州能够有所转变，尽管该州州长现在仍然满口异议，反对联邦法令，但有朝一日，那里的黑人男孩和女孩将能与白人男孩和女孩情同骨肉，携手并进。	Normal 1 3 梦想
他重重地掉在地上，光滑的壳上摔出了好多裂纹。	Normal 9 11 光滑
小洁紧紧攥着面包纸，生怕它掉进湖里。	Hard 4 6 攥着
五官溃烂，大小便不畅通，三更半夜在陕北甘泉县招待所转圈圈行走，以致招待所白所长犯了疑心，给县委打电话，说这个青年人可能神经错乱，怕要寻“无常”。	Normal 0 2 五官
我喜欢看秋天里摇曳的芒草。	Normal 4 7 秋天里
后来，铁路工务段派来刘长喜——人称“老刘头”来看桥。	Hard 5 8 工务段
泪水挂满了脸颊，拉起青布围裙擦一下，又连忙盛一大碗满满的白米饭，请瞎子先生吃，再给他一大包的米。	Normal 33 35 瞎子
夜来风雨声，花落知多少？	Hard 0 5 夜来风雨声
冈重岭复，乔木苍苍。	Hard 0 4 冈重岭复
摸着门道，花草养活了，而且三年五载老活着，开花，多么有意思呀！	Normal 5 7 花草
在事实上，亡国一次，即添加几个殉难的忠臣，后来每不想光复旧物，而只去赞美那几个忠臣；遭劫一次，即造成一群不辱的烈女，事过之后，也每每不思惩凶，自卫，却只顾歌咏那一群烈女。	Normal 18 20 忠臣
而她却坦然地接过去，自信地对我说：“不用绱，钉几个钉子就行了。”	Hard 20 21 绱
至如梁、柱、枋、標、门、窗、墙、瓦、植、阶、栏杆、隔扇、斗拱、正脊、垂脊、正吻、戗兽、正房、厢房、游廊、庭院、夹道等等。	Hard 8 9 標
另外，在一般学校学习的有30人，相对而言，一般城里孩子趋之若鹜的重点学校，却只有5名民工子女在其中就读。	Hard 27 31 趋之若鹜
那只母狼，为了保护它的幼崽，先是用爬坡减缓了我的速度，赢得了隐藏儿女的时间，又从容地用自己的尾巴抹平痕迹，并用全力向相反的方向奔跑，以一死换回孩子的生。	Normal 17 19 爬坡
25日凌晨1点35分8秒，它以合适的角度进入地球大气层。	Normal 15 17 合适
这一切都说完了，老信客又告诉他沿途可住哪几家小旅馆，旅馆里哪个茶房可以信托。	Normal 15 17 沿途
田间与灌木篱下，横陈着田凫、椋鸟、画眉等数不清的腐鸟的血衣，鸟儿的肉已被隐秘的老饕吃净了。	Hard 39 41 老饕
她来祭奠两个人。	Normal 0 1 她
我做的往往是诸葛亮、刘备一类的文角儿；只有一次我做史文恭，被花荣一箭从椅子上射倒下去，这算是我最活泼的玩艺儿了。	Hard 51 54 玩艺儿
夏洛克我找不到；约上没有这一条。	Normal 10 12 没有
险绝处的红漆栏杆，本身便是可美的风景。	Hard 0 3 险绝处
这些作品虽成过去，却仍虎虎有神，正如唐人郭震所形容的：“虽复尘埋无所用，犹能夜夜气冲天。”	Hard 28 35 虽复尘埋无所用
这是一个亭子形方殿，殿顶把四道垂脊攒在一起，正中安放着一个大圆金宝顶，轮廓非常优美。	Hard 15 17 垂脊
父亲看见了,赶快来到我的身边,把我撩起的棉被一把按下,连声说道:“我不冷,不冷。	Normal 6 8 赶快
透明的冰山，沸腾的大海，汹涌澎湃的大江大河，丁丁冬冬的泉水，潺潺的溪流，平静的湖水，北国千里冰封，万里雪飘，南国溟溟薄雾，潆漾细雨，还有那挂在红花绿叶上珍珠般晶莹的晨露，蓝天上飘浮的白云，以及危害庄稼的冰雹，所有这一切，气态的、固态的、液态的水，都是水的不同形态。	Hard 61 65 潆漾细雨
创始时候既已背时，失败时候当然无可告语，而其后却连这三个人也都为各自的运命所驱策，不能在一处纵谈将来的好梦了，这就是我们的并未产生的《新生》的结局。	Normal 67 69 新生
这类人物多是头脑简单，四肢发达，却十二分忠诚于秦腔，此时便拿了枝条儿，哪里人挤，哪里打去，如凶神恶煞一般。	Normal 17 20 十二分
虎门销烟这一伟大壮举，沉重地打击了外国侵略者的嚣张气焰，它向全世界表明：中国人民是不可欺侮的！	Normal 14 16 打击
萨沙朝蔷薇花丛走去。	Normal 5 7 花丛
然后每天站在虱子旁边，聚精会神地盯着它。	Normal 8 10 旁边
它没有婆娑的姿态，没有屈曲盘旋的虬枝，也许你要说它不美。	Hard 16 18 虬枝
皇帝手里拿着一根棍子，和地面平行，候选人员一个个依次跑上前去，有时候跳过横杆，有时候在横杆下面来回爬几遍，这完全要看横杆上升或者下降的情形而定有时候皇帝和首相各拿着木棍的一头。	Hard 77 79 首相
他们骄傲地举起了手，有的还神气十足地左顾右盼。	Normal 0 2 他们
她拖着铁罐子跑了一天，藏躲在什么地方，终于夤夜又复光临寒舍？	Hard 21 23 夤夜
伍若兰1906年出生于一个贫穷正直的教师家庭。	Normal 9 11 生于
我们从车窗里看见你，你这样的容光焕发，你的笑容多么甜美。	Normal 25 27 甜美
那是你爸爸捎回来的情报。	Normal 3 5 爸爸
独夜卧人静，风涛汹汹，直逼枕簟，鱼龙舞啸，其形声时入梦寐间，意洒然快也。	Hard 30 33 意洒然
这激怒了英雄惹地豪星，决心把这个恶差除掉。	Normal 4 6 英雄
在轻松幽雅的乐曲声里，只见他头上顶着高高的一摞金边红花白瓷碗，柔软而又自然地舒展着肢体，做出各种各样令人惊羡的动作，忽而卧倒，忽而跃起……	Normal 63 65 忽而
当日林如海教女以惜福养身，云饭后务待饭粒咽尽，过一时再吃茶，方不脾胃。	Hard 13 16 云饭后
我们甚至彼此并不知晓，每个人如何终身隐秘地镌刻着各自记忆的斑纹，爱与悔恨的斑纹。	Normal 37 39 斑纹
沅州上游不远有个白燕溪，小溪谷里生芷草，到如今还随处可见。	Normal 21 23 如今
哈姆莱特那不过是一种傻气的心理；可是一个女人也许会因为这种莫名其妙的疑虑而惶惑。	Normal 34 36 疑虑
一种极大，头胸浓绿色，腹部有黑色的环纹，尾部两侧有革质的小圆片，叫做“绿豆纲。”	Hard 25 27 革质
时云长在侧曰：“某闻管仲、乐毅乃春秋、战国名人，功盖寰宇；孔明自比此二人，毋乃太过？”	Hard 13 18 乐毅乃春秋
接着我静默下来，我陷入沉思或回忆，判断自己或分析别人，捕捉念头或欣赏思维，这时的思维像白纸上似是而非的显影线条，也像冬日村庄上空最先升起的炊烟轮廓，还像一朵停留在无风的秋空之间的云絮，也像寒冷天气里汽车引擎刚发动时的声响。	Normal 58 60 冬日
他还规定高山族子弟读书可以免除徭役。	Hard 15 17 徭役
但是，朋友，难道我就能忍住满心的欢喜和激动，不向你吐出我心中的“咿哑”？	Hard 32 34 咿哑
这里有特别美、特别大、色彩特别绚丽的老弗里茨像，他目光炯炯，身着天蓝色的军服，胸前的大星章金光闪闪。	Normal 36 38 军服
他仍是衣衫不整，仍是一面踱步一面埋头沉思。	Normal 1 2 仍
它不仅仅成了波兰人朝拜的圣地，举行精神宴会的殿堂，参观游览的古迹，而且为数众多的外国音乐家、钢琴家、作曲家都把造访这个伟大艺术家的摇篮、这个喷射出了肖邦伟大音乐的不竭源泉，看成自己一生的夙愿。	Hard 9 11 朝拜
那瀑布从上面冲下，仿佛已被扯成大小的几绺；不复是幅整齐而平滑的布。	Hard 18 20 几绺
就这样，终于走出栅栏，人流疏散开，前面已经显露出了三益大厦，年轻人煞住脚，这回不知怎么绷紧脸，挺不高兴的样子，挺生硬地说：“行啦，别跟着我啦，我看见啦。”	Normal 52 54 样子
又如大家所熟悉的范仲淹的《岳阳楼记》：“若夫淫雨霏霏，连月不开。	Hard 27 31 连月不开
这样，就将一切可能联合或中立的社会阶层，均联合或中立起来，集中力量反对国民党反动统治势力及乡村中为最广大群众所痛恨的少数恶霸分子。	Normal 24 26 中立
于是周围的一切——天空，海洋，高扬的帆，船尾水流的潺潺声——一切都像在诉说着爱情，诉说着幸福的爱情！	Normal 20 22 船尾
这时我第一次向地面报告飞行状态：“‘神舟五号’报告，整流罩打开正常！”	Hard 26 29 整流罩
船长哈尔威屹立在舰桥上，一个手势也没有做，一句话也没有说，随着轮船一起沉入了深渊。	Normal 31 33 轮船
街上突然加多了人，铺子里的人争着往外跑，都攥着把蒲扇遮着头，四下里找。	Hard 21 22 攥
屠格涅夫也常常带来一些外文书籍，并非常流利地翻译一些歌德和普希金的诗句。	Hard 26 28 歌德
傩送二老在茶峒地方不是一个生疏的名字！	Hard 0 2 傩送
秋天的一个下午，德诺的妈妈上街去买东西了，艾迪在病房陪着德诺，夕阳照着德诺瘦弱苍白的脸。	Normal 33 35 照着
忽一日，李小二正在门前安排菜蔬下饭，只见一个人闪将进来，酒店里坐下；随后又一人闪入来。	Hard 23 25 闪将
小哪吒可机灵啦，身子一闪，躲过了这一斧头，随便取下乾坤圈，向夜叉扔去。	Hard 30 32 夜叉
唯其如此，才需要我们日以继夜，终生的追求、苦练；要不然大家做了羲皇上人，垂手而天下治，做人也太腻了！	Hard 36 42 垂手而天下治
少年曰：“某乃卧龙之弟诸葛均也。	Hard 5 15 某乃卧龙之弟诸葛均也
每个牧人都不知道自己是歌唱家。	Hard 2 4 牧人
“后之视今，亦犹今之视昔”，你们不久也要走这条路呢！	Hard 7 9 犹今
晚6时15分，象征英国管治结束的告别仪式在距离驻港英军总部不远的添马舰军营东面举行。	Hard 32 37 添马舰军营
日上，正赤如丹，下有红光，动据承之。	Hard 13 17 动据承之
更可贵的是，它最乐于助人，其他四位兄弟稍微吃力的工作，都少不了它来帮忙。	Normal 28 31 少不了
冼星海做过饭馆的跑堂、理发馆的杂役、有钱人的仆人，经常在饥寒交迫中度日。	Normal 11 14 理发馆
他用的是一盆不冷不烫的温吞水，外加一条遮眼蔽耳的大毛巾，给我们慢慢洗头；他还晓得我们都喜欢花花绿绿的色彩，就尽力把我们头上的疮疖涂抹得花团锦簇，让我们出了剃头铺就能直奔玩具店。	Hard 62 64 疮疖
我恍惚了一下，紧紧握住他们的手。	Normal 9 11 握住
有弗学，学之弗能弗措也；有弗问，问之弗知弗措也；有弗思，思之弗得弗措也；有弗辨，辨之弗明弗措也；有弗行，行之弗笃弗措也。	Hard 36 39 有弗辨
宝玉听了，登时发作起痴狂病来，摘下那玉，就狠命摔去，骂道：“什么罕物，连人之高低不择，还说‘通灵’不‘通灵’呢！	Hard 41 42 择
《红楼梦》第四十九回里就有这样一段：“黛玉换上掐金挖云红香羊皮小靴，罩了一件大红羽绉面白狐皮的鹤氅，系一条青金闪绿双环四合如意绦，上罩了雪帽。”	Hard 31 33 小靴
杜暹先生藏书万卷，每卷后都亲题曰：“清俸买来手自校，子孙读之知圣道，卖及借人为不孝。”	Hard 0 2 杜暹
我绊了几次脚后，落在了后面。	Normal 11 13 后面
直到在一次修身课上，听了周恩来的发言才解开了这个谜。	Normal 19 21 解开
一些投考者穿着节日的盛装，夹着漂亮的琴盒和提包昂然走进巴黎音乐院的大门。	Normal 21 23 提包
张择端主要活动于北宋末年至南宋初年，生卒年不详，山东东武人，字正道，又字文友，幼读书游学于汴京，徽宗朝/进入翰林，据张著题跋，后习绘画，擅长界画，工/舟车、人物、市街、城郭，自成一家。	Normal 51 52 /
大虫见掀他不着，吼一声，就像半天里起了霹雳，震得那山冈地动了，接着把铁棒似的虎尾倒竖起来一剪。	Normal 41 43 竖起
风娃娃来到田野，看见一架大风车正在慢慢转动，抽上来的水断断续续地流着。	Normal 19 21 转动
黄鸟和小巧玲珑的白眉鸫,尖声尖气地吹着笛子。	Hard 8 11 白眉鸫
宋洪迈《容斋续笔》中指出：这首诗原作“春风又到江南岸”，几经推敲，改了几次才定了“绿”字。	Hard 4 7 容斋续
学会了怎样用潜水镜以后，你就可以背上氧气瓶穿上脚蹼，在小湖或江河里，一边蹬水悠闲地游来游去，一边观察水底。	Normal 48 50 观察
这里“霏”和“开”押韵（不完全韵），“空”和“形”押韵（不完全韵），“摧”和“啼”押韵（不完全韵），“讥”和“悲”押韵，“明”、“惊”和“顷”、“泳”、“青”押韵（平仄通押），“璧”和“极”押韵，“忘”和“洋”押韵。	Hard 82 86 平仄通押
豪星看了心痛如焚，情急生智，动员男女老幼采来蒿杆扎成火把，漫山遍野燃烧起来，经过九天九夜的激战，终于消灭了天虫，保住了即将收获的庄稼。	Normal 61 63 收获
黑色的猪群不停地呼噜着。	Normal 0 2 黑色
这个方案的设计者期望当三峡工程完成之后，在三峡库区依然可以重现白鹤梁随水隐现的自然景观。	Normal 5 8 设计者
这样，如果暴涨理论是正确的，宇宙就应包含足够的暗物质，使得密度达到临界值。	Hard 33 36 临界值
他诧异地同时讨好地看了我一眼。	Normal 4 6 同时
几星萤火优游来去，不像飞行，像在厚密的空气里飘浮。	Normal 9 11 不像
只见那人说道：“我自有伴当烫酒。	Hard 11 15 伴当烫酒
凤娇照例跑到第三节车厢去找她的“北京话”，香雪系紧头上的紫红色围巾，把臂弯里的篮子换了换手，也顺着车身一直向前走去。	Normal 28 31 紫红色
这样，如果暴涨理论是正确的，宇宙就应包含足够的暗物质，使得密度达到临界值。	Normal 20 22 足够
哪里有洪水，哪里就有军旗飘扬；哪里有危险，哪里就有军徽闪烁。	Hard 25 29 军徽闪烁
两地纬度相差无几，因为烟台靠海，春天便来得迟了。	Hard 2 8 纬度相差无几
我把两只猫都带到岸上；至于那条狗，它是在我第一次搬东西上岸的第二天自动跳下船，泅到岸上来找我的，后来作了我多年的忠仆。	Hard 39 40 泅
煮饭老妈子从此就骇破了胆，后来一提起，还是立刻面如土色，自己轻轻地拍着胸埔道：“阿呀，骇死我了，骇死我了……”	Normal 21 23 立刻
这里没有汽车，大小船挤在大运河里，穿梭般的来往不绝。	Normal 8 10 小船
可是大半月过去了，竟丝毫没有动静。	Normal 14 16 动静
这可以成为一个反对克隆人的理由，但这个理由不能在根本上反对克隆人。	Normal 13 15 理由
到三阳春吃碗热热的排骨大面，回来这里已经有人给摆上一张弹簧沙发，坐上去舒舒服服地接着看。	Normal 9 11 排骨
您别说不好，这一来也就练出不少能人来。	Normal 11 13 练出
有一种人，读书虽然不多，但他对于人情事理，都很通达，凭借经验，运用心得，“官知止而神欲行，依乎天理，批大郤，导大窾”。	Hard 54 57 导大窾
吃完饭，他叫了一辆马车，到布洛涅树林去兜风。	Normal 9 11 马车
那里不种棉花，我刚到那里的时候，老大娘们手里搓着线锤。	Normal 16 19 老大娘
我心里还愤愤的，以为惩戒得还没有快意。	Hard 16 18 快意
正是水的不同形态，使我们的地球环境“淡妆浓抹总相宜”，总是那么美丽，充满了生机。	Hard 18 25 淡妆浓抹总相宜
蝈蝈有着有力的大颚、锐利的钳子，不能把它的俘虏开膛破肚的情况极少出现，因为蝉没有武器反驳，只能哀鸣踢蹬。	Hard 7 9 大颚
认儿子不是好开交的呢。	Hard 6 8 开交
凡尔赛宫建于路易十四时代，1661年动土，1756年竣工，至今已有222年的历史。	Normal 10 12 时代
啪啪声里，一道道浆，衔接得天衣无缝，刷过去的墙面，真好比平平整整打开一面雪白屏障。	Normal 28 32 平平整整
过了没几天，队伍扎营在一片坟地。	Normal 13 15 坟地
有时捏住笼子，它会从竹篦的洞里咬你的指头肚子一口。	Hard 10 12 竹篦
但是这个文件，在我死后，这一克镭就成为私人财产，成为我女儿的产业。	Normal 19 21 私人
假如我变成了一朵金色花，只为了好玩，长在那树的高枝上，笑哈哈地在空中摇摆，又在新生的树叶上跳舞，妈妈，你会认识我么？	Normal 15 17 好玩
晴天是好天气，晒果脯的大儿子会高兴；下雨也是好天气，做伞的小儿子会高兴。	Hard 8 10 果脯
几枝松，几个观松人，溶出溶入；一幅幅，有似古山水，笔意简洁。	Normal 27 29 简洁
从锭子上取下穗子，也像从果树上摘下果实，劳动以后收获的愉快，那是任何物质享受都不能比拟的。	Hard 1 3 锭子
老人摇摇头说：“这不过是无心插柳柳成荫。”	Hard 12 19 无心插柳柳成荫
刘：各位听众，这时候我们看到直升机已经飞抵落点上方，对火箭落水瞬间施放的荧光染色剂进行精度照相测量。	Hard 43 45 精度
全场沸腾了，许多人眼睛里噙满激动的泪花，雷鸣般的掌声经久不息。	Normal 17 19 泪花
懂得了我说过的那些个话，都是让人害臊的话。	Normal 0 2 懂得
那是个晴朗的日子，我乘汽车来到藏龙山，只见漫山遍野都是大大小小的水池。	Normal 19 21 只见
把管庄的家人都从乡里叫了上来。	Normal 8 10 乡里
坚持一天两次一小时的训练，需要耗费我能够掌握的所有意志与自制——一旁还有萨沙的袖珍光盘播放机正在大声喧哗。	Normal 32 34 一旁
及至看到了林场，这种亲切之感更加深厚了。	Normal 10 12 亲切
江理以“从者七人，二僧与俱”，组成一支浩浩荡荡的登山队，“一仆前持斧斤，剪伐丛莽，一仆鸣金继之，二三人肩糗执剑戟以随。”	Hard 41 47 一仆鸣金继之
这也是千古名句，可是这里的“高树多悲风”却并没有落叶的形象，而“寒风扫高木”则显然是落叶的景况了。	Hard 14 19 高树多悲风
医生的好意和歉意，他都很麻木，而护士的阻拦只能引起他暴怒的把两个护士都赶走。	Normal 35 37 赶走
被子植物的花有了花被，更分化为花萼和花冠（花被和花冠通称花瓣）。	Hard 8 10 花被
郭沫若的散文像他的诗一样，有的写得豪放激越、气势磅礴，也有的写得柔婉清丽、秀美含蓄。	Hard 22 26 气势磅礴
我把那件印着骄傲的仰着头的大角麋鹿的运动衫放在柜台上，抱着鞋盒走出商店。	Hard 15 17 麋鹿
明天不要让他们捆我或是遮上我的眼睛，我会安安稳稳地站在那儿。	Normal 27 29 那儿
昆虫翅膀好看的，为螳螂及纺织娘。	Hard 12 15 纺织娘
麋鹿的尾巴是鹿科动物中最长的。	Hard 0 2 麋鹿
例如《诗经·鲁颂》的《駉》这一首诗里提到马的名称就有16种：“驈”(身子黑而胯下白的)，“皇”(黄白相间的)，“骊”(纯黑色的)，“黄”(黄而杂红的)，“骓”(青白杂的)，“駓”(黄白杂的)，“騂”(红黄色的)，“骐”(青黑成纹像棋道的)，“驒”(青黑色而有斑像鱼鳞的)，“骆”(白马黑鬃)，“駵”(红马黑鬃)，“雒”(黑马白鬃)，“駰”(灰色有杂毛的)，“騢”(红白杂毛的)，“驔”(小腿长白毛的)，“鱼”(两眼旁边毛色白的)。	Hard 87 88 駓
我用鞭子着实教训了它一顿。	Hard 4 6 着实
理智上，我知道我的头发不比使用香波前干净多少——尘土能到哪里去？——	Normal 24 26 尘土
余闻者甚夥，久记于心；尔后虽多用于《神鞭》、《三寸金莲》等书，仍有一些故事人物，闲置一旁，未被采纳。	Hard 3 5 甚夥
一会，吴太太从大门走进，面有余怒，进来后，即走进正屋。	Normal 24 26 正屋
与其它鹿科动物一样，麋鹿也是一种草食性哺乳动物。	Normal 5 7 动物
简直可以说是他除了三害。	Hard 9 11 三害
这时它的光已不耀眼了，山也暗淡了，云也暗淡了，树也暗淡了。	Normal 19 21 暗淡
于是，一套套令人眼花缭乱的快速打法：平拉开、短平快、交叉……	Normal 22 25 短平快
我鼻子里喷着冷气：“那个小没良心的，哼！”	Normal 6 8 冷气
那只雄吐绶鸡一生下来脚上就有距，因此他就以为自己是一个皇帝。	Hard 2 6 雄吐绶鸡
不管从哪个角度看，你都能见到热带森林般茂密的须发。	Normal 19 21 茂密
我把它放在身边的窗栏上，让它苏醒过来，那时它的生命的火焰跳动还是很微弱，它依然静静地伏着；我于是把几朵盛开的鲜花放在它的触须前面，让它可以有一点东西吃；正在这时一只鸫鸟在窗前响亮而又神气地唱起歌来，唱得嘹亮极了；、我不禁大声说:你听，这只小鸟歌唱得多愉快，那么你这小小的生命也必须恢复过来才是！	Hard 82 84 鸫鸟
老船夫搓着手说：	Normal 1 3 船夫
中华文化就是在这块土地上发祥的。	Normal 9 11 土地
“你只有一克镭么？”	Hard 6 7 镭
观众像着了魔一样，忽然变得鸦雀无声。	Normal 9 11 忽然
皇帝手里拿着一根棍子，和地面平行，候选人员一个个依次跑上前去，有时候跳过横杆，有时候在横杆下面来回爬几遍，这完全要看横杆上升或者下降的情形而定有时候皇帝和首相各拿着木棍的一头。	Normal 58 60 横杆
自然是江南日暮的雪景；“寒沙梅影路，微雪酒香村”，则雪月梅的冬宵三友，会合在一道，在调戏酒姑娘了；“柴门闻犬吠，风雪夜归人”，是江南雪夜更深人静后的景况；“前村深雪里，昨夜一枝开”，又到了第二天的早晨，和狗一样喜欢弄雪的村童来报告村景了。	Normal 50 52 柴门
从祖父和那长年谈话里，翠翠听明白了二老是在下游六百里外沅水中部青浪滩过端午的。	Hard 27 29 沅水
徽曰：“孔明与博陵崔州平、颍川石广元、汝南孟公威与徐元直四人为密友。	Hard 13 15 颍川
可惜煞您了，您的脑子那么好，怎么就不把您留下，留下个我干啥呀……	Hard 2 3 煞
小时候常听老太婆口头语：“十年难逢金满斗”，意思是盛会难逢，参加后，才知道原来这种会，只有正当金星入斗那一年才举行的。	Hard 13 20 十年难逢金满斗
鲁迅先生走路很轻捷，尤其使人记得清楚的，是他刚抓起帽子来往头上一扣，同时左腿就伸出去了，仿佛不顾一切地走去。	Normal 4 6 走路
向导一边走一边发出悲叹：“如果不是我们，这些海龟根本就不会受到那样的伤害。”	Normal 22 24 海龟
费了很大工夫找来了一个律师，拟定了附属证书。	Hard 17 21 附属证书
先在东三省立了个小宣统的满洲国，又在口外立了个德王的蒙疆政府，往后没有殷汝耕的公文护照，不许出口一步。	Normal 31 33 往后
他深深地吸了一口气，使劲向风车吹去。	Normal 6 9 一口气
鲁迅一面上书塾，一面要帮家务，天天奔走于当铺和药铺之间。	Normal 23 25 药铺
伯父去世了，他的遗体躺在万国殡仪馆的大礼堂里，许多人都来追悼他，向他致敬，有的人甚至失声痛哭。	Normal 0 2 伯父
池塘里绒被一样厚厚的浮萍，凸起来了，再凸起来，猛地撩起一角，唰地揭开了一片；水一下子聚起来，长时间的凝固成一个锥形；啪地摔下来，砸出一个坑，浮萍冲上了四边塘岸，几条鱼儿在岸上的草窝里蹦跳。	Normal 23 25 猛地
麦当劳店堂里宜人的温控环境和悦耳的轻音乐，使不少中国顾客把麦当劳作为闲聊、会友、亲朋团聚、举行个人或家庭庆典仪式甚至某些学者读书写作的好地方。	Normal 17 20 轻音乐
他不忍心再朝这死鱼看上一眼，因为它已经被咬得残缺不全了。	Normal 14 16 因为
这是那么神秘，那么美得不可思议，我不禁反复吟诵歌德那首诗的最后一行:“啊，但愿你在这里！”……	Normal 17 19 不禁
在传统的石拱桥的基础上，我们还造了大量的钢筋混凝土拱桥，其中“双曲拱桥”是我国劳动人民的新创造，是世界上所仅有的。	Hard 22 25 混凝土
因为她不明白这笑话有几分真，又不清楚这笑话是谁诌的。	Hard 23 24 诌
他们带利斧和美制的十字镐来，带工作灯来，人造的强光把举镐挥斧的影子投射在路面上，在公寓二楼的窗帘上，跳跃奔腾如巨无霸。	Hard 55 58 巨无霸
我正在左右搜寻,立明对我努劝嘴——只见不远处站着一个穿夹克衫的壮汉,一脸木然,好像根本不知道发生的事。	Hard 12 15 努劝嘴
美猴王领一群猿猴、猕猴、马猴等，分派了君臣佐使，朝游花果山，暮宿水帘洞，合契同情，不入飞鸟之丛，不从走兽之类，独自为王，不胜欢乐。	Hard 36 40 合契同情
我们上车，翻过龟背山，进入罗布泊古湖盆。	Normal 2 4 上车
那些物体悬浮在飞船外面，我无法捕捉回来，我至今还没弄清那到底是什么。	Normal 7 9 飞船
老师听了，赞许地点了点头，说：“小丽做得对！”	Normal 10 12 点头
“五老上天都”“姊妹牧羊”“仙人下轿”“仙人把洞门”“老僧入定”“猪八戒吃西瓜”“仙女绣花”“丞相观棋”“仙人踩高跷”“八仙飘海”等等，这一类是拟人的，都离不了神仙气。	Normal 72 74 拟人
徐霞客却卓尔不群，醉心于古今史籍及地志、山海图经的收集和研读。	Normal 14 16 史籍
河底为坚硬的岩盘，在水力的长期冲刷下，形成了一道三十米至五十米宽的深槽。	Normal 10 12 水力
荀子阐发孟子的人伦说，提出“群居和一”之道（《荀子・荣辱》），作为人类生活的基本准则。	Hard 14 18 群居和一
那拱桥的强劲的大弧线，或方桥的单纯的直线，都恰好与芦苇丛构成鲜明的对照。	Normal 8 10 弧线
他耐心地、不露声色地等待着，准备着。	Normal 1 3 耐心
放眼望去，尽是姑娘们的七彩裙、花头帕、绣花坎肩和小伙子们的白披毡、蓝披毡、花腰带，好像一个硕大无朋的五彩花环罩在青苍的碧野上。	Normal 50 52 五彩
至于视觉经验，也都表现得很有动感：写荷花迎风则“红披绿偃，摇荡葳蕤”，写微风拂水则“细生鳞甲”，写流萤则“（幽火）班班，若骇若惊，奄忽去来”，写山则“森森欲下搏人”。	Hard 65 69 奄忽去来
这个机关的负责人帮助保尔住进了一所专科医院。	Hard 17 21 专科医院
开始我看得津津有味，天长日久，就感到不过瘾了。	Normal 3 4 看
成人期女孩所共有的害羞的感觉，在这些被叫做“猪猡”的生物中间，已经很迟钝了。	Normal 34 36 迟钝
“真的，”爷爷表示同意，“不只是鸟儿造窝需要毛，就是野兽啦，耗子啦，松鼠啦，也都需要，这对它们全是好东西。”	Normal 34 36 松鼠
时云长在侧曰：“某闻管仲、乐毅乃春秋、战国名人，功盖寰宇；孔明自比此二人，毋乃太过？”	Hard 19 23 战国名人
果一变变作个鱼鹰儿，飘荡在下溜头波面上。	Normal 2 4 变变
又如天坛皇穹宇与罗马的布拉曼提所设计的圆亭子，虽然大小不同，基本上是同一体裁的“文章”。	Normal 8 10 罗马
如果我们把这种具象化的旅行，抽象化为人生的旅途，我们不分彼此，都是苦旅者。	Normal 11 13 旅行
它的眼睛闪闪有光，并且目光十分坦率；它的耳朵也长得好，并且不大不小，不像牛耳太短，驴耳太长；它的鬣毛正好衬着它的头，装饰着它的颈部，给予它一种强劲而豪迈的模样；它那下垂而茂盛的尾巴覆盖着、并且美观地结束着它的身躯的末端：马尾和鹿、象等的短尾，驴、骆驼、犀牛等的秃尾都大不相同，它是密而长的鬃毛构成的，仿佛这些鬃毛就直接从屁股上生长出来，因为长出鬃毛的那个小肉桩子很短。	Hard 144 146 鬃毛
沅州上游不远有个白燕溪，小溪谷里生芷草，到如今还随处可见。	Normal 13 15 溪谷
一条清澈见底的小溪，终年潺潺地环绕着村庄。	Hard 12 14 潺潺
他们很不赞成，认为一个学生要独立思考，这简直是不折不扣的异端。	Normal 11 13 学生
他们带利斧和美制的十字镐来，带工作灯来，人造的强光把举镐挥斧的影子投射在路面上，在公寓二楼的窗帘上，跳跃奔腾如巨无霸。	Hard 9 12 十字镐
凡尔赛宫的修建，有一段历史轶事。	Normal 5 7 修建
假如你要报恩，那就请你回去后，不要对人说我在这里，因为人们贪图我的皮角，万一坏人知道了，一定会来伤害我的。	Hard 33 35 皮角
当年六纵的敌工部长卢耀武，后来成为了一名闻名全军的作家，他在《挥军渡淮》一文中记载了许多在大别山群众中流传的神话：有的说是五黄六月，下着棉花疙那样大的雪，解放军踏着冰封的河面来的；有的说是每人背了一个大葫芦飘浮过来的；又有的说，是起了一阵大黄风，把刘伯承将军的六十万人马刮到大别山来的。	Normal 133 135 人马
情况是危急的，伯瑙德夫人知道，蜡烛燃到金属管处就会自动熄灭，情报就会泄露，同时也意味着他们一家三口的生命将告结束。	Hard 7 10 伯瑙德
每年秋天，我的庶祖母同我到田里去“监割”（顶好的田，水旱无忧，收成最好，佃户每约田主来监割，打下谷子，两家平分），我总是坐在小树下看小说。	Hard 36 38 佃户
地下两溜十六张楠木交椅，又有一副对联，乃乌木联牌，镶着錾银的字迹，道是：	Hard 22 24 联牌
祖父用拳头把自己腿重重地捶着，且笑着：“翠翠，你人乖，爷爷笨得很，话说得不温柔，莫生气。	Normal 0 2 祖父
他扬鞭一挥，车便辚辚向前。	Hard 8 12 辚辚向前
在希望渺茫的将来，如果炎症能够消失，可以试试做孔手术。	Normal 11 13 炎症
可是，学生们没有任何动作；除了有几个年纪较大的把泪在脸上流成很长很亮的道子，没有人出声。	Normal 41 43 出声
它是一堵垂直的峭壁，壁面有许多凸出来的岩石、崩土和蓬乱的灌木。	Hard 22 24 崩土
许多植物都有先天克隆的本领。	Normal 11 13 本领
小刺猬也高兴极了，说：“谢谢你，你的称赞消除了我一天的疲劳！”	Normal 6 8 极了
记得童年与家人在庭院纳凉，母亲总要背诵唐人“银烛秋光冷画屏，轻罗小扇扑流萤”的诗句，其情境真够令人销魂的了。	Hard 30 37 轻罗小扇扑流萤
幽兰吐秀乔林下，仍自盘根众草傍。	Hard 14 15 傍
须知著书固要智慧，读书也要智慧。	Hard 2 4 著书
然后是卖青菜和卖花儿的，讲究把挑子上的货品一样不漏地都唱出来，用一副好嗓子招徕顾客。	Normal 15 17 挑子
它的成分并不和一般通用的意义一样，里面是较少的籼米、锅焦、碎米和较多的乡下人用来喂猪的豆腐渣！	Normal 9 11 通用
从破屋顶的窟窿里看得见椽子。	Hard 11 13 椽子
要不然，则当佳节大典之际，他们拿不出东西来，只好磕头贺喜，讨一点残羹冷炙做奖赏。	Hard 32 36 残羹冷炙
他这次不像以往那么立刻起身，观众也不像以往那样马上给他掌声，都陷入了一种回味，都浸淫了一种酸楚的离情。	Normal 11 13 起身
但“人”不仅是在系统发育谱上属于脊椎动物门、哺乳动物纲、灵长类、人科、人属的人，而且是心理、社会的人（person，人格）。	Normal 51 57 person
小男孩摆弄了很久很久，说：“一切准备停当。”	Hard 18 20 停当
您的马车在长满绿草的、树影斑驳的小路上行驶着；黄色的大苍蝇一动不动地在金黄色的空气中停了一会儿，突然飞去；小蚊蚋成群地盘旋着，在阴暗的地方发亮，在太阳光里发黑；鸟儿安闲地歌唱着。	Hard 53 56 小蚊蚋
六岁的小女孩柔弱的身体成了黑脸大汉手中一块生面团，翻过来、椆过去、立起来、横过去，抻、拉、压、拽，为所欲为，奶奶看不过我被整得满脸的泪水和汗水，每次都目不忍视地躲到里屋。	Hard 29 30 椆
他真的往一个地方看，那儿有一抹淡影，他觉得那地方有一缕烟，隐隐约约，可是风却吹不走。	Normal 10 12 那儿
他欠起身子，四下里打量着，回想着，好半天才弄明白：自己是躺在湿漉漉的草地里。	Normal 18 20 半天
在同一时刻，海峡彼岸的台湾花莲慈济医院，骨髓移植专家李博士正步履匆匆地走进手术室。	Normal 35 37 走进
天每天升高一丈，地每天下沉一丈，盘古也随着越长越高。	Hard 5 7 一丈
他们砸开了门，从过道偷偷地涌进了厨房，闯人了房间。	Normal 16 18 厨房
他们依靠天赋的才能，用冷静的头脑信任自己的才能，相信它会使他们走上正路，因为天赋的才能是属于他们自己的。	Normal 11 13 冷静
这个计划建立的“工作框架图”所提供的序列，经生物信息的加工与其他技术的研究，已鉴定了近4万个基因，而且已经克隆了几十种与疾病直接有关的“疾病等位基因”。	Hard 18 20 序列
可贾里总不能在校园中同邱士力比武，或者动刀动枪像武打小说一样。	Normal 24 26 武打
到晚上，他就穿上宽大的羊皮袄，敲着梆子，在别墅的周围走来走去。	Hard 17 19 梆子
即使当它枝枯叶落的时候，当它已经作为木料制作成家具的时候，它的香气仍然不变。	Normal 31 33 香气
毫无疑问，6500万年前地球上曾经有过一次“大灭绝”，发生过一次“大劫难”。	Normal 12 14 地球
我从他俨然的脸色上，又忽而疑他正以为我不早不迟，偏要在这时候来打搅他，也是一个谬种，便立刻告诉他明天要离开鲁镇，进城去，趁早放宽了他的心。	Hard 39 41 谬种
士兵骑象杀敌，战象用长鼻劈敌，用象蹄踩敌，一大群战象，排山倒海般地扑向敌人，势不可当。	Normal 0 2 士兵
沙漠里的大风是很可怕的，大风卷着沙粒飞滚，有时会移来整座沙丘，把人和牲口全埋在底下。	Normal 28 30 沙丘
人们在河边涮洗着衣服和新摘下来的青菜；每当傍晚时分，酷爱清洁的女人们就会来到河里洗澡，平日里穿的五颜六色的筒裙，这时变成了一个个色彩斑斓的“浴罩”浮在水面上，她们有时还在水中嬉戏，在夕阳的映衬下，更显出几分妩媚。	Normal 23 25 时分
如此说来，“孤城寡人”并不正常，虽然，已经司空见惯了，习以为常了，倒是“与狼共舞”这个漂亮而荒诞的词组更具有现代意识。	Normal 56 58 意识
又如大家所熟悉的范仲淹的《岳阳楼记》：“若夫淫雨霏霏，连月不开。	Hard 20 26 若夫淫雨霏霏
“男爵爱卿，”他厉声言道，“朕想卿也明白，‘陛下’这个称呼在全国范围内只属于孤家一人，再没有旁人称得起‘陛下’了！	Hard 38 40 孤家
但是，如果只凭冲劲，天不怕地不怕，就随便往羊皮筏上一蹲，那也会出大乱子。	Hard 7 9 冲劲
我们一到了街上，我的朋友老雄猫就寒颤了一会儿。	Normal 5 7 街上
真君撞进门，大圣见了，现出本相道：“郎君不消嚷，庙宇已姓孙了。”	Normal 11 13 现出
元刘信将三岁痴儿抛入蘸纸火盆，妄希福佑，是见于《元典章》的；剧本《小张屠焚儿救母》却道是为母延命，命得延，儿亦不死了。	Hard 15 19 妄希福佑
我忐忑着，拿了书来了。	Normal 5 6 拿
然而她反满足，口角边渐渐的有了笑影，脸上也白胖了。	Hard 7 9 口角
在山冈小径上，我看到一只蚂蚁在拖蜣螂的尸体。	Hard 16 18 蜣螂
但是它伟岸，正直，朴质，严肃，也不缺乏温和，更不用提它的坚强不屈与挺拔，它是树中的伟丈夫！	Normal 19 21 温和
她松松地皱缬着，像少妇拖着的裙幅；她轻轻地摆弄着，像跳动的初恋的处女的心；她滑滑地明亮着，像涂了“明油”一般，有鸡蛋清那样软，那样嫩，令人想着所曾触过的最嫩的皮肤；她又不杂些儿尘滓，宛然一块温润的碧玉，只清清的一色——但你却看不透她！	Hard 4 6 皱缬
3百万电子伏特的电子感应加速器，这个加速器完全有能力产生一束反电子。	Hard 30 33 反电子
现在，人们又发明了电力机车、太阳能汽车、磁悬浮列车、核潜艇，还有了可以遨游太空的宇宙飞船和航天飞机。	Normal 14 17 太阳能
燕雀、鸢和歌声婉转的鸫鸟,用清脆、纯净的声音唱着。	Hard 10 12 鸫鸟
我有一天在积雨少住的早晨和德熙从联大新校舍到莲花池去。	Hard 5 9 积雨少住
我是个沧海曾经的人，对于海却总是漠然地，这或者是因为我会晕船的缘故罢！	Hard 3 7 沧海曾经
公爵大家让开些，让他站在我的面前。	Hard 0 2 公爵
母亲生前没给我留下过什么隽永的哲言，或要我恪守的教诲，只是在她去世之后，她艰难的命运，坚忍的意志和毫不张扬的爱，随光阴流转，在我的印象中愈加鲜明深刻。	Hard 12 14 隽永
我把它安置在临河的石埠上。	Normal 6 8 临河
我的朋友们，“他说，“我的期友们，我，我，……	Hard 13 15 期友
冰箱里面用到一种纳米涂层，具有杀菌和除臭功能，能够使食物保质期和蔬莱保蛘期更长。	Normal 0 2 冰箱
凤姐备好一圈坐椅，让边吃酒边行令，等待梨香院的戏开台。	Hard 14 16 行令
都说明白，オ不致与同名人相混淆。	Normal 5 6 オ
这闭着的眼睛便看见一切圆满，当前的苦痛不过是“天之将降大任于是人也，必先苦其心志，劳其筋骨，饿其体肤，空乏其身，行拂乱其为”。	Hard 56 61 行拂乱其为
结果是从轻发落予以开释，但是厨师坚持不能不稍予膺惩，即在猫身上原来的铁丝上系一只空罐头，开启街门放她一条生路。	Hard 21 25 稍予膺惩
这一天，哈墨尔先生特别为我们准备了崭新的字模，上面用漂亮的花体字写着：“法兰西，阿尔萨斯，法兰西，阿尔萨斯。”	Hard 4 7 哈墨尔
再还有‘日落江湖白，潮来天地青’：这‘白’‘青’两个字也似无理。	Hard 10 15 潮来天地青
“逼”“急”“黑”三字把暮色和人之间动的关系，扣得又紧又有戏剧感：“黑行”二字，浓缩得感性已达饱和点。	Normal 16 18 之间
假如我拥有一切，我就无所用心。	Hard 10 14 无所用心
当公寓里的伙伴替我提了随身小提箱，领我到这房间来的时候，我瞥见这绿影，感觉到一种喜悦，便毫不犹疑地决定下来，这样了截爽直使公寓里伙计都惊奇了。	Hard 56 60 了截爽直
餐桌上饭菜丰盛极了，有烤羊肉串、清炖羊肉、曲曲，还有许多说不出名字的食品。	Hard 21 23 曲曲
“肥皂”的名称出于皂角树，从前把它的荚果捣烂搓成丸子，用来洗脸洗澡洗衣服，现在用的肥皂是用油脂和碱制成的，跟皂角树无关。	Normal 24 26 丸子
当日林如海教女以惜福养身，云饭后务待饭粒咽尽，过一时再吃茶，方不脾胃。	Normal 10 12 养身
我们往往还会看到触须的颤抖和触角以及腹肌十分明显的运动：彼此盆开，然后突然并拢。	Hard 30 32 盆开
傣味的品种很多，有用芭蕉叶包裹起来蒸的猪肉，有用竹板夹住或用香茅草包好扎紧放在火上烤的竹鼠，还有烤鱼、烤竹笋、剁生菜等等。	Normal 56 58 生菜
例如《诗经·鲁颂》的《駉》这一首诗里提到马的名称就有16种：“驈”(身子黑而胯下白的)，“皇”(黄白相间的)，“骊”(纯黑色的)，“黄”(黄而杂红的)，“骓”(青白杂的)，“駓”(黄白杂的)，“騂”(红黄色的)，“骐”(青黑成纹像棋道的)，“驒”(青黑色而有斑像鱼鳞的)，“骆”(白马黑鬃)，“駵”(红马黑鬃)，“雒”(黑马白鬃)，“駰”(灰色有杂毛的)，“騢”(红白杂毛的)，“驔”(小腿长白毛的)，“鱼”(两眼旁边毛色白的)。	Hard 31 32 驈
反正我没搞清楚，还是少管闲事。	Normal 0 2 反正
他愁苦地望着我泪水盈眶的眼睛，问：“那一半呢？”	Normal 19 21 一半
磨房的若望·孚罗洛向他的朋友罗班·普斯潘说道，（这两个学生当然随着犯人到这儿来了，）“他还没有一只关在盒子里的金龟子明白呢。”	Normal 51 53 盒子
记得童年与家人在庭院纳凉，母亲总要背诵唐人“银烛秋光冷画屏，轻罗小扇扑流萤”的诗句，其情境真够令人销魂的了。	Hard 22 29 银烛秋光冷画屏
这是一头健壮结实的奶牛，曾经有过所有奶牛都有过的生活经历，它产下了小犊，然而连看它们一眼舔它们一下都没有来得及便被人带走了，这以后便吃着粗粝的草料，心甘情愿地把牛奶奉献出来。	Normal 18 20 奶牛
马路上没有人，也没有汽车，但红灯亮了，立即从自行车上下来，等在标志线前的小伙子。	Hard 31 34 标志线
玄德曰：“且勿惊动。”	Hard 5 9 且勿惊动
在西部有好几处沙疗疗养院。	Hard 7 9 沙疗
手提梢棒便走。	Hard 2 4 梢棒
小芹那年才九岁，晌午做捞饭，把米下进锅里了，听见她娘哼哼得很中听，站在桌前听了一会，把做饭也忘了。	Hard 11 13 捞饭
人类基因组计划所发展起来的战略与技术使生物资源由原先的群体种质（野生与优质品种的种质）资源转变为序列化与信息性，技术带来的资源信息性又使它的保护更为困难。	Hard 29 31 种质
有弗学，学之弗能弗措也；有弗问，问之弗知弗措也；有弗思，思之弗得弗措也；有弗辨，辨之弗明弗措也；有弗行，行之弗笃弗措也。	Hard 52 59 行之弗笃弗措也
这些红艳耀目的荷花，高高地凌驾于莲叶之上，迎风弄姿，似乎在睥睨一切。	Hard 29 31 睥睨
林冲和差拨两个在路上，又没买酒吃处，早来到草料场外。	Hard 3 5 差拨
笑了一阵，他忽然若有所思地说：“不过，人类也许应该从旅鼠身上学到点什么。	Hard 26 28 旅鼠
有弗学，学之弗能弗措也；有弗问，问之弗知弗措也；有弗思，思之弗得弗措也；有弗辨，辨之弗明弗措也；有弗行，行之弗笃弗措也。	Hard 12 15 有弗问
今诸君苟不于此时植其基，勤其学，则将来万一因生计所迫，出而仕事，但任讲席，则必贻误学生；置身政界，则必贻误国家。	Hard 12 15 勤其学
“喂，这像不像渣滓洞的生活？”	Normal 11 13 生活
屋里屋外都没有雨来的踪影。	Normal 5 7 没有
若果他那文章还值得称引，我们尚可以就“沅有芷兮澧有兰”与“乘舲上沅”这些话，估想他当年或许就坐了这种小船，溯流而上，到过出产香草香花的沅州。	Hard 19 26 沅有芷兮澧有兰
他和妈妈把爸爸的骨灰盒请回来，放在爸爸生前读书的写字台上，那顶象征和平的蓝盔搁置其上。	Hard 36 38 蓝盔
阿依穆罕大娘还用糜米放在瓦罐里，做出了一种既像黄酒、又像啤酒、也像喀瓦斯、还像哈萨克夏牧场的酸马奶一样的叫做“泡孜”的饮料，喝上一口，酸、苦、甜、凉、热俱全，我也很喜欢。	Normal 4 6 大娘
我眼前又浮现出引人入胜的课堂，热火朝天的劳动，又去开心的郊游，你追我赶的赛场……	Normal 28 30 郊游
“你喜欢吃烤薄饼么？”	Normal 2 4 喜欢
那是上初中二年级时，我写了一篇八百字的小小说，投寄刚创办的县报，在一星期后刊登了。	Normal 19 22 小小说
像有一只巨人的手拿着明晃晃的大刀在外边想挑破那灰色的幔，像是这巨人已在咆哮发怒;越来越紧了，一闪一闪满天空瞥过那大刀的光亮，隆隆隆,幔外边来了巨人的愤怒的吼声!	Hard 26 27 幔
“天行健，君子以自强不息；地势坤，君子以厚德载物。”	Hard 13 16 地势坤
二是人口迅速增长，无限制地开垦放牧，使森林毁灭，草原破坏，绿色的植被遭到严重破坏，黄土高原失去天然的保护层，引起了严重的水土流失。	Normal 47 49 天然
撒切尔先生告诉他：为了防止再有人迷路，魔克托尔山洞的出口被封死了。	Normal 11 13 防止
将军既帝室之胄，信义著于四海，总揽英雄，思贤如渴，若跨有荆、益，保其岩阻，西和诸戎，南抚彝、越，外结孙权，内修政理；待天下有变，则命一上将将荆州之兵以向宛洛，将军身率益州之众以出秦川，百姓有不箪食壶浆以迎将军者乎？	Hard 96 100 箪食壶浆
原来这种制作方法开头的时候多用蓝色料，当时叫点蓝，就此叫开了（我们苏州管银器上涂色料叫发蓝，大概是同样的理由）。	Normal 8 10 开头
他们手挽手，笑嘻嘻地回到欧洲。	Normal 10 12 回到
我因为还有足够的力量来扞卫自己的心，而感到一种突如其来的自豪。	Normal 19 21 感到
甚至有的乞丐也油嘴滑舌地编起快板：“老太太（那个）真行好，给个饽饽吃不了。	Hard 14 16 快板
江干上下十余里间，珠翠罗绮溢目，车马塞途。	Normal 0 2 江干
但是，皇帝也迫切需要臣子的智慧，也就是在决策的关头，提出反对的意见，也就是谏。	Hard 37 38 谏
崔杼等他写好,拿过竹简一看,上面写着:“夏五月,崔杼谋杀国君光。”	Hard 24 26 崔杼
他们将自己的手掌按在石头上，然后往上喷赭色或者黑色的粉末。	Normal 6 8 手掌
那些老爷既然不愿意遵守法令，现在就得管管他们。	Normal 2 4 老爷
一去二三里，烟村四五家。	Normal 8 11 四五家
“青海长云暗雪山，孤城遥望玉门关。	Hard 1 8 青海长云暗雪山
太阳并不在这个大车轮的中心，跟中心的距离约为二万七千光年。	Hard 26 28 光年
我这熊熊地燃烧着的生命，我这快要使我全身炸裂的怒火，难道就不能迸射出光明了吗？	Normal 14 16 快要
及至始皇，奋六世之余烈，振长策而御宇内，吞二周而亡诸侯，履至尊而制六合，执敲扑而鞭笞天下，威振四海。	Hard 36 39 执敲扑
人们可以对我们具有确定证据的那些星系和星系团中的暗物质的量作一个相当可靠的估算。	Hard 24 27 暗物质
单瓣的花虽没有双瓣者的豪华，但它却更有一段妙幻的演艺，红玛瑙的花瓶儿由希腊式的安普刺变为中国式的金罍，殷、周时代古味盎然的一种青铜器。	Hard 48 50 金罍
大家立刻都赞成，和开船时候一样踊跃，三四人径奔船尾，拔了篙，点退几丈，回转船头，驾起橹，骂着老旦，又向那松柏林前进了。	Normal 9 11 开船
“子在川上曰：‘逝者如斯夫，不舍昼夜。’”	Hard 8 13 逝者如斯夫
一女愿侍痼疾之夫，《醒世恒言》中还说终于一同自杀的；后来改作的却道是有蛇坠入药罐里，丈夫服后便全愈了。	Hard 4 6 痼疾
有对白俄夫妇，已没落到做苦工，他们对打工者的苦楚深表同情，竟用很微薄的工资帮助我——请我吃饭。	Normal 4 6 夫妇
这个计划建立的“工作框架图”所提供的序列，经生物信息的加工与其他技术的研究，已鉴定了近4万个基因，而且已经克隆了几十种与疾病直接有关的“疾病等位基因”。	Hard 53 55 克隆
至谷底，我们坐在水边的一块岩石上，隔着一口小小的绿潭，那一幅白帘般的瀑布，仿佛一伸手便可撩过来拭脸似的，它跃入涧底激起的烟雾般的水珠，直扑到我们脸上，沁凉沁凉的。	Normal 64 66 水珠
种橡树，种山毛榉，还种白桦树。	Hard 5 8 山毛榉
因为它长得粗壮结实，样子也不大好看，还特别在前面加一个“侉”字，叫做“侉叫蛐子”。	Hard 35 39 侉叫蛐子
在这迟疑之中，双喜可又看出底细来了，便又大声的说道，“我写包票！	Hard 29 31 包票
然秦以区区之地，致万乘之势，序八州而朝同列，百有余年矣；然后以六合为家，崤函为宫；一夫作难而七庙隳，身死人手，为天下笑者，何也？	Hard 48 49 隳
据说当时曾用狼粪来作燧，因为狼粪的烟可以直上云霄，远处容易看见，所以又称烽火台为狼烟台。	Hard 9 11 作燧
“也是，岁数不饶人哪！”	Hard 4 9 岁数不饶人
观赏云海成了正当的借口，可以稍许偷懒片刻。	Normal 2 4 云海
周围一片漆黑，船桅的梢尖勉强可辨。	Normal 0 2 周围
时令已经是秋天了。	Normal 5 7 秋天
这些说法都有一定的道理，但又不能让人完全信服。	Normal 2 4 说法
从这些观测绘出的天空图可以显示辐射的不同温度。	Normal 8 10 天空
她记起祖父嘱咐她不要离开原来地方那一句话，便又为自己解释这想头的错误，以为祖父不来必是进城去或到什么熟人处去，被人拉着喝酒，一时不能脱身。	Normal 37 39 祖父
手术完成之后，用相同频率的电脉冲刺激换核卵，让苏格兰黑面羊的卵细胞质与芬多席特母羊乳腺细胞的核相互协调，使这个“组装”细胞在试管里经历受精卵那样的分裂、发育而形成胚胎的过程。	Hard 36 39 多席特
我的眼里噙满了泪水。	Normal 7 9 泪水
教授提出要到他家看看，雷棣和妈妈热情地接待了他。	Normal 14 16 妈妈
“吃音玻璃”就是消除噪音的能手。	Normal 13 15 能手
我推开大人们，跑到穿衣镜前，横刀立马地一照，呀，哪里是小关公，我是大关公哪！	Normal 9 12 穿衣镜
千余年来读书人对于桃源的印象，既不怎么改变，所以每当国体衰弱发生变乱时，想做遗民的必多，这文章也就增加了许多人的幻想，增加了许多人的酒量。	Normal 4 7 读书人
直到今天，不少的民歌，不少的地方戏曲，仍旧保存着这一个具有民族特点的、具有抑扬的美的诗歌节奏。	Normal 19 21 仍旧
陆虞侯告道：“不干小人事；太尉差遣，不敢不来。”	Hard 15 17 差遣
珊迪听了，目不转睛地看着我，好像表示感激。	Normal 14 16 好像
只是小人家离得远了，过几时，那工夫来望恩人。	Normal 3 5 人家
在发现镭之后的不断研究中，居里夫人也在不停地变化着。	Hard 3 4 镭
一天夜里，一个小姑娘拿着水罐走出家门，为她生病的母亲去找水。	Normal 21 23 生病
虽然一切想法都在心中确定无疑，可是这个“朝拜”仍然是神圣而必须进行的。	Normal 26 28 神圣
平静的江面，越往东越宽，在雨后的秋阳下，笼罩着一层白蒙蒙的薄雾。	Normal 16 19 秋阳下
