明朝遗臣史可法等人拥立福王称帝南京，组织人马抗击清军。	Complex 2 4 遗臣
古丽拜尔婶婶笑容可掬地给我们斟上奶茶，阿伊霞姐姐给我拿来馓子，阿吉让我先尝尝无花果……	Hard 28 30 馓子
迷人的张家界，名副其实的人间仙镜。	Complex 7 11 名副其实
但我所流落的岛上，没有我的非洲看到的那种野兽。	Complex 3 5 流落
可惜它们并不真正存在，当彩虹悄然隐去，海市无声消失的时候，人们仍然只能依靠自己的双脚走出戈壁，去寻找活水和黑土，寻找蔚蓝色的大海和坚实的船帆。	Complex 58 60 蔚蓝
至于视觉经验，也都表现得很有动感：写荷花迎风则“红披绿偃，摇荡葳蕤”，写微风拂水则“细生鳞甲”，写流萤则“（幽火）班班，若骇若惊，奄忽去来”，写山则“森森欲下搏人”。	Hard 54 59 幽火）班班
忽然，我看到一个衣衫褴褛的中年人疲软地靠在一堵墙上，他的眼睛闭着，黧黑的脸扭曲如一截枯根，不知在忍受什么。	Hard 33 35 黧黑
理智上，我知道我的头发不比使用香波前干净多少——尘土能到哪里去？——	Hard 15 17 香波
不料叫圩子上一个万员外看中了，死逼着龙家父子连夜替他赶造一条大船，准备把当地粮米都搜刮起来，到合浦去换珠子，好献给皇帝买官做。	Hard 3 5 圩子
这是一种终身受益的教训。	Complex 4 8 终身受益
痛苦的呼号的回声在我心中回荡，饥饿的儿童，被压迫者折磨的受害者，被儿女视为负担的无助的老人，以及充满孤寂、贫穷和痛苦的整个世界，都是对人类应有生活的嘲讽。	Complex 74 76 嘲讽
小路两边是松林，军汉实在走不动了，都放下担子，到树荫下躺倒休息。	Complex 24 26 树荫
在安造垸，他们救出了被洪水围困了三天三夜的幼儿园老师周运兰；在簰州湾，他们给攀上树梢等待了近九个小时的小江珊以生的希望……	Hard 31 34 簰州湾
喜鹊多是成双成对，而灰喜鹊则成帮成伙，一来就是一大群，它们高高地在树枝上跳来跳去，飞来飞去，叫来叫去，非常活跃，为这座学府式的大庭院带来了一派生机和欢快。	Complex 14 18 成帮成伙
这一道工序技术难度很高，窑内温度始终要保持在800℃～940℃，才能使陶俑各部分受热均匀，烧出后“视之色如青石，扣之声如磬玉”。	Hard 56 62 扣之声如磬玉
开船以后，水路中的风景，盒子里的点心，以及到了东关的五猖会的热闹，对于我似乎都没有什么大意思。	Hard 26 29 五猖会
然而，从哥白尼③时代开始，我们就被降级为绕着一颗非常平凡的恒星公转的一颗行星，而该恒星又是绕着我们看得见的不过是一千亿个星系中的一个典型星系的外边缘公转。	Hard 31 33 公转
又转回头来望着女儿，说道：“我早上拿了钱来，你那该死行瘟的兄弟还不肯，我说：‘姑老爷今非昔比，少不得有人把银子送上门来给他用，只怕姑老爷还不稀罕。’	Hard 26 28 行瘟
有一次，我把只黄蜂放进一个蛛网中，但当蜘蛛照常出门来捕食时，先是观察一下来的是个什么样的敌人，根据量力的原则，制伏不了的对手，它立刻主动上去解除紧紧束缚对手的丝线，以放走这样一个强大的敌人。	Complex 49 51 量力
这时候上来一道汤，汤里的冬笋、蘑菇、荸荠等拼成各种图案，简直就是精美的工艺品。	Hard 18 20 荸荠
弯下身去用纯白的云潮来洗手洗脚，又走到云潮没胸处做双臂划水的动作。	Complex 8 10 云潮
全裸的笔尖，旋拧的笔帽。	Complex 0 2 全裸
有一次武委会训练村干部，恰巧小二黑发疟疾没有去。	Hard 18 20 疟疾
还请了一个细娃当裁判。	Hard 5 7 细娃
把自己想象为仙女是女孩子的虚荣心。	Complex 13 16 虚荣心
怀疑不仅是消极方面辨伪去妄的必需步骤，也是积极方面建设新学说、启迪新发明的基本条件。	Complex 31 33 启迪
我自小练过脚板，如今抬腿一二十里也是寻常事。	Complex 5 7 脚板
但是它驯良不亚于勇毅，它一点儿不逞自己的烈性，它知道克制它的动作：它不但在驾驭人的手下屈从着他的操纵，还仿佛窥伺着驾驭人的颜色，它总是按照着从主人的表情方面得来的印象而奔腾，而缓步，而止步，它的一切动作都只为了满足主人的愿望。	Complex 16 17 逞
平静的江面，越往东越宽，在雨后的秋阳下，笼罩着一层白蒙蒙的薄雾。	Complex 29 31 薄雾
有弗学，学之弗能弗措也；有弗问，问之弗知弗措也；有弗思，思之弗得弗措也；有弗辨，辨之弗明弗措也；有弗行，行之弗笃弗措也。	Hard 24 27 有弗思
很快，“周恩来”这个名字和“为中华崛起而读书”，在全校师生中传播开来。	Complex 17 19 崛起
后来，拉小提琴成了我无法割舍的爱好，我能熟练地拉许多曲子。	Complex 12 14 割舍
凡卡嘴角撇下来，拿脏手背揉揉眼睛，抽噎了一下。	Complex 17 19 抽噎
大平原托着的小屯里，左邻右舍的窗子上，都贴着姥姥心灵手巧的劳作。	Hard 6 8 小屯
以前看见包弟作揖，我就想笑，这些天我在机关学习后回家，包弟向我作揖讨东西吃，我却暗暗地流泪。	Hard 19 21 机关
他说道，看着牛虻伤肿的手臂，“你可以仍然住在原来的牢房里，死因牢又黑又暗。”	Hard 6 8 牛虻
唉，多可惜，他的腿瘫痪了，好像天公总叫他还不了心愿。	Complex 9 11 瘫痪
直到那时我们才察觉我们度过的每一天时光，都赋予我们不同的色彩和形态。	Complex 7 9 察觉
大圣见了，搜的一翅飞起去，变作一只大鹚老，冲天而去。	Hard 17 20 大鹚老
一个乞丐来到一座庭院，向女主人乞讨。	Complex 15 17 乞讨
蜻蜓飞得那么快，哪里会追得上？	Complex 0 2 蜻蜓
您的马车在长满绿草的、树影斑驳的小路上行驶着；黄色的大苍蝇一动不动地在金黄色的空气中停了一会儿，突然飞去；小蚊蚋成群地盘旋着，在阴暗的地方发亮，在太阳光里发黑；鸟儿安闲地歌唱着。	Hard 53 56 小蚊蚋
水在颤动中发出淙淙声响，青草仿佛在这乐声中生长，水影显得那么调和。	Hard 7 9 淙淙
又枕帕头巾边沿用茉莉花苞作装饰的，比用小三角锯齿纹（通称狗牙齿）时代早些，狗牙齿边盛行于晚清，茉莉花流行于同光时，至于四合如意规矩格子花，则是二百年前式样。	Complex 75 77 式样
这时，宇航员们感到自己的身体轻飘飘的，无法在座舱里站稳，稍一抬脚，就会跳起三四米高。	Hard 22 24 座舱
剥开粽叶，咬一口粽子，真是又黏又甜。	Complex 14 15 黏
那人因祸得福，赶快一面吃着灵芝草，一面对天盟誓，愿给鹿、鸟永远当奴仆，一辈子伺候他们。	Complex 19 23 对天盟誓
我和爸爸一起登上了这棵大树雄伟的枝杈，我们脚踏在水桶粗的横干上，手抓住坚硬的枝条，迎风站在离地有十来米高的半空中——风好大呀，蓝天白云，田野碧绿，小河在发着亮……	Complex 13 15 雄伟
当时三人坐下，李逵便道：“酒把大碗来筛，不奈烦小盏价吃。”	Hard 14 15 把
次日早起五更，在府里把担仗都摆在厅前，老都管和两个虞候又将一小担财帛，共十一担，拣了十一个壮健的厢禁军，都做脚夫打扮。	Hard 25 27 虞候
巨大的漕船，舳舻相接，忙碌的船工从停泊在河边的粮船上卸下沉重的粮包，纤夫们拖着船，逆水行驶，一片繁忙景象。	Hard 6 10 舳舻相接
但是这个文件，在我死后，这一克镭就成为私人财产，成为我女儿的产业。	Complex 15 16 镭
胡早秋这才看到了西圩堤上的人影，忙掉转车头，迎着水流冲向圩堤。	Hard 9 11 圩堤
她带着些惊惶的神情说。	Complex 4 6 惊惶
夜来风雨声，花落知多少？	Hard 6 11 花落知多少
“可是人不是生来要给人家打败的，”他说，“人尽可被毁灭，可是不会肯吃败仗的。”	Complex 34 36 败仗
有时候，他引诱你到语言文字的穷边涯际，下面是深秘的静默：“此中有真意，欲辨已忘言。”	Hard 35 40 欲辨已忘言
渐渐地，我读诗读出了兴趣，也会比较同一类题材的不同写法和诗人不同的情感表达方式，也关心起诗人的身世际遇了，我因此增长了不少知识。	Complex 47 51 身世际遇
可以毫不夸张地说，在这里，培育一棵树的费用抵得上培养一个孩子。	Complex 21 24 抵得上
这是一句诗一样美的妙语。	Complex 9 11 妙语
腊月二十三过小年，香烛纸马送灶王爷上天。	Hard 14 17 灶王爷
开始我看得津津有味，天长日久，就感到不过瘾了。	Complex 10 14 天长日久
博识的人们觉得他单调，他自己也以为不幸否耶？	Hard 19 21 否耶
后来时移事迁，岁月流逝，池塘里却变得“半亩方塘一鉴开，天光云影共徘徊”，再也不见什么荷花了。	Complex 7 11 岁月流逝
但是看到舷窗玻璃开始出现裂缝，我紧张了，心想：完了，这个舷窗不行了。	Hard 4 6 舷窗
急下马向前施礼，问曰：“先生非卧龙否？”	Hard 14 18 非卧龙否
保尔在海边找了张长発坐下，把脸对着日光，太阳已不那么晒人了。	Hard 8 10 长発
难道我这个人将以荷而传吗？	Hard 7 11 以荷而传
极天云一线异色，须臾成五采。	Hard 5 7 异色
他读过私塾，年长后外出闯码头，碰了几次壁，穷愁潦倒，无以为生，回来做了信客。	Complex 35 37 信客
当时副刊最有名的，是《申报》的《自由谈》和《新闻报》的《快活林》，都是后来被鲁迅先生称之为“鸳鸯蝴蝶派”的主要阵地，内容浅薄无聊。	Hard 46 50 鸳鸯蝴蝶
光绪三十四年（1908）我从成都回来，在仪陇县办高等小学，一年回家两三次去看母亲。	Complex 20 23 仪陇县
只是它的联想的意义迷离不易捉摸，它可以联想到燃烧弹，鸦片烟榻，庙里焚香，“一川烟水”，“杨柳万条烟”，“烟光凝而暮山紫”，“蓝田日暖玉生烟”……	Hard 52 59 烟光凝而暮山紫
记得我还是小男孩的时候，晚上洗澡常常呻吟抱怨，在这种意义上，我认为空间站是小孩子的天堂。	Complex 18 22 呻吟抱怨
李白诗云“燕山雪花大如席”，不知有几万、几十万朵雪花才能黏连成一片席那么大呢！	Complex 28 30 黏连
太史季说:“我当然爱惜性命。	Complex 0 3 太史季
而她却坦然地接过去，自信地对我说：“不用绱，钉几个钉子就行了。”	Hard 20 21 绱
大紫檀雕螭案上，设着三尺来高青绿古铜鼎，悬着待漏随朝墨龙大画，一边是金蜼彝，一边是玻璃。	Hard 34 37 金蜼彝
我们现在已经回到了我们的后院——离地球1光年的地方。	Hard 20 22 光年
这样，人们在实际上经常只能对未来相当短的时间作准确的预言。	Complex 26 28 预言
他找来休假的儿子替他看桥，自己三天两头往工务段跑，找领导向办法解决问题。	Complex 15 19 三天两头
心中想着，忽见丫鬟话未报完，已进来了一位年轻的公子：头上戴着束发嵌宝紫金冠，齐眉勒着二龙抢珠金抹额；穿一件二色金百蝶穿花大红箭袖，束着五彩丝攒花结长穗宫绦，外罩石青起花八团倭缎排穗褂；登着青缎粉底小朝靴。	Hard 70 71 攒
淘气的孩子们去听窗，学会了这两句话，就给两位神仙加了新外号：三仙姑叫“前世姻缘”，二诸葛叫“命相不对”。	Hard 7 9 听窗
黄山松多生长在海拔800米到1700多米的高山上，还有不少就长在峭壁岩缝之中，黄山松针叶短粗稠密，顶平如削，干曲枝虬，苍翠奇特。	Complex 54 58 干曲枝虬
但当我哀悼隐鼠，给它复仇的时候，一面又在渴慕着绘图的《山海经》了。	Complex 3 5 哀悼
即使荒野露宿，栖身洞穴，也要“燃松拾穗，走笔为记”。	Hard 15 19 燃松拾穗
不久，英国政府采纳了罗兰希尔的建议，批准了世界上第一种邮资凭证——邮票，规定信件不超过半盎司（相当于14克），收费1便士。	Hard 44 46 盎司
然而，这种爱看戏的嗜好，很快地引起了她爱打扮的需要。	Hard 9 11 嗜好
美国人用崇拜明星的方式表现他们的热情。	Complex 4 6 崇拜
闻到那股子香喷喷的味道，好想吃啊！	Complex 5 8 香喷喷
过了这么多年，藤萝又开花了，而且开得这样盛，这样密，紫色的瀑布遮住了粗壮的盘虬卧龙般的枝干，不断地流着、流着，流向人的心底。	Hard 37 41 盘虬卧龙
“小李，这个苹果你吃了吧，好润润喉咙。”	Complex 14 18 润润喉咙
在那春之宫殿，同粉蝶追欢取乐的桃花，自下而上，攀附他物的紫罗兰，还有那以富贵夸耀人世的牡丹，早已沉没在尘俗的荒漠里。	Complex 23 25 攀附
太阳落山了；一颗星在落日的火海里发出颤抖的闪光来……	Complex 18 20 颤抖
悼公于是决定由祁午继任中军慰。	Hard 11 14 中军慰
我的眼里噙满了泪水。	Hard 4 6 噙满
至今我许多曲稿还留在她那里，许多书籍稿件也放在别处间小寓所里，因为没钱交房租，不能去取回来，但愿现在还在。	Complex 5 7 曲稿
我和同事们面对一方泥土，七嘴八舌地讨论起来，认定不能太娇，也不能太雅，太娇太雅都不是我们能服侍得了的。	Complex 45 47 服侍
在工作过程中，他必须凭记忆整页整页，甚至整章整章地背诵，因此母亲有时觉得他疯了。	Complex 22 24 整章
由于另一条鲨鱼正在蹂躏死鱼的缘故，船身还在晃荡，老头儿松开了帆脚绳，让船向一边摆动，使鲨鱼从船底下出来。	Hard 9 11 蹂躏
他们对圆明园进行了大规模的劫掠，赃物由两个胜利者均分。	Complex 13 15 劫掠
它的成分并不和一般通用的意义一样，里面是较少的籼米、锅焦、碎米和较多的乡下人用来喂猪的豆腐渣！	Hard 26 28 锅焦
它不同于：“美女妖且闲，采桑歧路间；柔条纷冉冉，落叶何翩翩。”	Hard 18 23 柔条纷冉冉
先一步赶来指挥渡河的李达参谋长要求十八旅必须在午夜12点钟以前渡完。	Complex 10 12 李达
陆虞侯告道：“不干小人事；太尉差遣，不敢不来。”	Hard 15 17 差遣
一想到他就要离开这儿，从此再也见不到他了，我就忘记了他以前给我的处罚，忘记了他如何用戒尺打我。	Hard 42 44 戒尺
刘伯承假装没有看见，只等他们快要撵拢身边，才一个纵步跳进麻柳林。	Hard 16 18 撵拢
待到学校恢复旧观，往日的教职员以为责任已尽，准备陆续引退的时候，我才见她虑及母校前途，黯然至于泣下。	Hard 43 45 黯然
他们相同的思想、哲学观点和才能;共同的趣味、生活和梦想;相同的文学主张和狂热的理想，共同的鉴赏能力与博学多识使他们两人常常是一拍即合，一见面，两人都不约而同地感到一种与其说是相互理解的愉快，倒不如说是心灵内在的欢乐。	Complex 74 78 不约而同
昆虫翅膀好看的，为螳螂及纺织娘。	Hard 12 15 纺织娘
在病床前苦苦服侍了他数年的养母，悲声大放：“我怎么就把您服侍下个这样儿……	Complex 16 20 悲声大放
水塘中，还有一顶即将下沉的红星军帽。	Complex 10 12 下沉
那计较都是吴用主张，这个唤作“智取生辰纲”。	Hard 17 20 生辰纲
我也怅然的，愤恨的，在诅骂着那个不知名的夺去我们所爱的东西的人。	Complex 11 13 诅骂
聂将军见这孩子两眼里流露出惊恐的神色，就拿过一个洗干净的梨子，和蔼地说：“这梨洗干净了，吃吧！”	Complex 31 33 和蔼
我看见蜘蛛把它的腿像球一样旋动，静静地躺上几小时，一直小心翼翼地注视着外界的动静，当一只苍蝇碰巧爬得够近时，它就忽然冲出洞穴，攫住它的俘获物。	Hard 63 65 攫住
其实，这也并非什么奇特的事情，在上海的弄堂里，租一间小房子住着的人，就时时可以体验到。	Complex 19 21 弄堂
那些戴旧毡帽的大清早摇船出来，到了埠头，气也不透一口，便来到柜台前面占卜他们的命运。	Hard 17 19 埠头
而有地炉、暖炕等设备的人家，不管它门外面是雪深几尺，或风大若雷，躲在屋里的两三个月的生活，却是一年之中最有劲的一段蛰居异境；老年人不必说，就是顶喜欢活动的小孩子们，总也是个个在怀恋的，因为这中间，有的是萝卜、雅儿梨等水果的闲食，还有大年夜、正月初一、元宵等热闹的节期。	Complex 57 61 蛰居异境
兀自不快下拜，等几时！	Hard 7 10 等几时
巢窠散落在地面上，小耗子又会发现它们，将毡靴的残毛搬进自己地下的窝中。	Hard 20 22 毡靴
接受了香山饭店的设计工作后，他不但多次到香山勘察地形，攀登峰顶，俯览周围环境，而且不辞劳苦地走访了北京、南京、扬州、苏州、承德等地，考察当地的大建筑和园林，最后采取了建筑一系列不规则院落的布局方式，使它与周围的水光山色、参天古树融为一体。	Complex 41 45 不辞劳苦
一边还咄念道：“等得住你！”	Hard 3 5 咄念
我们所能找到的惟一安慰是，我们在心里知道飞得那样高那样自豪的你们，现在在星际之外找到了上帝许诺以不朽生命的归宿。	Complex 48 50 不朽
然秦以区区之地，致万乘之势，序八州而朝同列，百有余年矣；然后以六合为家，崤函为宫；一夫作难而七庙隳，身死人手，为天下笑者，何也？	Hard 36 38 崤函
桐城派的文体以“味淡声希，整洁从容”自矜，也难怪表情较平，节拍较缓。	Complex 8 12 味淡声希
江理以“从者七人，二僧与俱”，组成一支浩浩荡荡的登山队，“一仆前持斧斤，剪伐丛莽，一仆鸣金继之，二三人肩糗执剑戟以随。”	Hard 4 8 从者七人
第八回里的一首绝句，嘲讽聊城杨氏海源阁（书中改称东昌府柳家）的藏书，虽不是好诗，却也不是造谣言的。	Complex 10 12 嘲讽
我于是日日盼望新年，新年到，闰土也就到了。	Complex 5 7 盼望
“你原来是条整鱼。	Hard 6 8 整鱼
我在田老师门下受业四年，听到上千个故事。	Hard 7 9 受业
各种各样的飞禽纷纷落到河边的牛蒡草上，它们啄食牛蒡尖儿的时候，发现了爷爷的毡靴。	Hard 37 39 毡靴
蝉、螳螂、黄雀，它们都—心想得到眼前的利益，却没顾到自己身后正隐伏着祸患呢！	Complex 34 36 祸患
及至始皇，奋六世之余烈，振长策而御宇内，吞二周而亡诸侯，履至尊而制六合，执敲扑而鞭笞天下，威振四海。	Hard 8 11 之余烈
在夜雨中与家人围炉闲谈，几乎都不会拌嘴；在夜雨中专心攻读，身心会超常地熨帖；在夜雨中思念友人，会思念到立即寻笔写信；在夜雨中挑灯作文，文字也会变得滋润蕴藉。	Hard 75 77 蕴藉
邢夫人苦留吃过晚饭去，黛玉笑回道：“舅母爱惜赐饭，原不应辞，只是还要过去拜见二舅舅，恐领了赐去不恭，异日再领，未为不可。	Complex 43 44 领
即使荒野露宿，栖身洞穴，也要“燃松拾穗，走笔为记”。	Hard 20 24 走笔为记
我问我自己，然后我听见了回应，回应来自童年旧居旁的河水，我听见多年以前被狂风带走的苦楝树苗向我挥手示意，我在这里，我在水里！	Hard 41 45 苦楝树苗
升旗的时候，礼炮响起来。	Complex 0 2 升旗
京口瓜洲一水间，钟山只隔数重山。	Hard 2 7 瓜洲一水间
我曾读到一个警句，是“愿你生命中有够多的云翳，来造成一个美丽的黄昏”。	Complex 20 22 云翳
尽管如此，万户那种勇于实践的探索精神，却使人们的内心深处受到了极大的震撼和鼓舞，他因此被国际航天史学家公认为人类升空探索的先驱。	Complex 34 36 震撼
多少年来，每到春天，我总要挑个风和日丽的日子，带上孩子们到郊区的野地里去挖荠菜。	Complex 37 39 荠菜
为了造成这样的麻醉，膜翅目猎手使用了当今先进科学可能会向实验生理学家建议的办法，即借助有毒的螫针破坏指挥运动器官的神经中枢。	Hard 46 48 螫针
傣族人对水天生就有一种崇敬感，村寨一般都建在水边，傣族人最隆重的节日是泼水节，他们在村里的饮水井上修建起一座神塔，在装饰得五颜六色的塔身上，镶嵌着许多小镜子，以求得到神灵的保护。	Complex 15 17 村寨
一只姬蜂往四面八方乱窜，水面却纹丝不动。	Complex 2 4 姬蜂
又经过了很长很长的年代，它们的前肢和尾巴渐渐变成了鳍，后肢完全退化了，整个身子成了鱼的样子，适应了海洋的生活。	Hard 25 26 鳍
即使克隆人的一些理由本身可以成立(例如解决不育、防止显性遗传病)，一且迈出克隆人的第一步，后面就很难阻挡。	Hard 26 28 显性
温暖的火、喷香的米饭和滚热的洗脚水，把我们身上的疲劳、饥饿都撵走了。	Hard 30 32 撵走
中小户人家，忌讳较少，遇到产妇胎位不正，老娘束手，老娘就会建议：“去请陈小手吧。”	Hard 22 24 束手
姑娘们心跳着涌上前去，像看电影一样，挨着窗口观望。	Complex 22 24 观望
一阵窸窸窣窣的声音，每个人都拿出讲义，端端正正摆在面前。	Complex 19 23 端端正正
由于水土流失，使河道泥沙淤积，河床抬高，湖泊面积缩小，湖泊的蓄洪能力降低。	Complex 12 14 淤积
然而她反满足，口角边渐渐的有了笑影，脸上也白胖了。	Hard 7 9 口角
克拉维切克因为是面包师傅出身，被派到供给部去做检査员，其余的人都派到普夏一沃季查去了。	Complex 18 21 供给部
虽然我毫无疑义地判定儿子患的只是普通感冒，如果寻找适宜锻炼看病的病种，这是最好的选择，但我还是深深地谴责自己。	Hard 32 34 病种
而且，还有一些人渴望去探索许多世纪以来前人所挖掘的坑道。	Complex 25 27 坑道
又湖南湘西地区部分挑花绣，地材有用桃红色羽纱和水绿色羽纱的，从材料流行时代分析，可知必是六七十年间作品，虽在苗区发现，实是汉人制作。	Complex 9 12 挑花绣
他一边跑一边叫：“不好了，不好了，‘咕咚’来了，大家快跑哇！”	Complex 18 20 咕咚
用这种话来描绘人类是可以的。	Complex 5 7 描绘
张乡绅攀谈道：“世先生同在桑梓，一向有失亲近。”	Hard 13 15 桑梓
再用鸡肉脯子，还有香菌、新笋、蘑菇、五香豆腐干子，各色干果子，都切成丁儿，拿鸡汤煨干了，拿香油一收，盛在磁罐子里封严了。	Complex 52 55 磁罐子
像鸽子笼一般地分得均匀，每边八排，每排五户，一共八十户一楼一底的房屋，每间工房的楼上楼下，平均住着三十二三个“懒虫”和“猪猡”，所以，除了“带工”老板、老板娘、他们的家族亲戚和穿拷绸衣服的同一职务的打杂、请愿警之外，这工房区域的墙圈里面住着二千左右衣服褴褛而替别人制造衣料的“猪猡”。	Hard 126 128 褴褛
中华文化就是在这块土地上发祥的。	Complex 12 14 发祥
一种比饥饿更可怕的东西平生头一次潜入了我那童稚的心……	Complex 21 23 童稚
在我自己的想象中，也觉得于月明风清之下，观览江头浪潮奔驰，比在白日里太阳光下的，要有趣味得多。	Complex 24 26 浪潮
“也是，岁数不饶人哪！”	Hard 4 9 岁数不饶人
是口、胃、肝、脾、肠等消化器官。	Complex 7 8 脾
你是个破落户，若是和俺硬到底，洒家倒饶了你。	Hard 15 17 洒家
更复射，终不能入石矣。	Hard 7 9 入石
蚂蚁一骨碌爬起来，想都没想，又换了种姿势，像只蜣螂那样头顶着地，用后腿往上举。	Hard 23 25 蜣螂
《千家诗》中很大一部分诗歌歌咏祖国风物，按春夏秋冬时序编排，打开书往下念，四季风光就活生生地展现在眼前：“成紫千红总是春”，“春城无处不飞花”；“绿树阴浓夏日长”，“五月榴花照眼明”；“青女素娥俱耐冷，月中霜里斗婵娟”；“梅雪争春未肯降，骚人搁笔费评章”……	Hard 93 100 青女素娥俱耐冷
它们过分热情地扑向过分冷漠的荒丘，不管人家愿不愿意，就去亲吻就去拥抱，热烈疯狂，缱绻缠绵，完全是一种自己的方式。	Hard 40 44 缱绻缠绵
我将看见所有的人们在我面前低头，鞠躬，匍匐，连同我的尊长，我的师友，和从前曾在我面前昂头阔步、耀武扬威的人们。	Hard 26 28 尊长
几个纤夫见他们的伙伴挨了打，唿哨而上；只听咯吧一声，一丈青大娘折断了一棵茶碗口粗细的河柳，带着呼呼风声挥舞起来，把这几个纤夫扫下河去，就像正月十五煮元宵，纷纷落水。	Complex 2 4 纤夫
国耻家很，都完全可以让他对美军轰炸日本本土感到兴奋。	Complex 15 17 轰炸
杨志道：“既然老都管说了，教这厮们买吃了，便起身。”	Complex 14 17 这厮们
美索不达米亚、希腊、小亚细亚以及其他各地的居民，为了得到耕地，毁灭了森林，但是他们做梦也想不到，这些地方今天竟因此而成为不毛之地，因为他们使这些地方失去了森林，也就失去了水分的积聚中心和贮藏库。	Complex 88 90 积聚
新的环境伦理则在更理性的层面上告诉人们，乡土野草是值得尊重和爱惜的，它们之于人类和非人类的价值绝不亚于红皮书上的一类或二类保护植物。	Complex 51 54 红皮书
金龟子的折扇，跟天牛长长的须角、锹甲的铁锹般的上颚一样，都是发育成熟可以求偶的标志，只是外形各不相同而已。	Hard 19 21 铁锹
其出不出，间不容发。	Hard 0 4 其出不出
牛虻面对他们，微笑着站好，枪在士兵们的手中不住地抖动着。	Complex 24 26 抖动
大熊猫如今分布地域十分狭窄，仅见于我国四川省的岷山、邛崃山和大小凉山，甘肃省的南缘和陕西省秦岭南麓等海拔2000～3500米的崇山峻岭。	Hard 26 29 邛崃山
奥斯里克殿下，王上已经用六匹巴巴里的骏马跟他打赌；在他的一方面，照我所知道的，押的是六柄法国的宝剑和好刀，连同一切鞘带钩子之类的附件，其中有三柄的挂机尤其珍奇可爱，跟剑柄配得非常合式，式样非常精致，花纹非常富丽。	Hard 57 59 鞘带
父亲说：“我们不能光顾眼前。	Complex 9 11 光顾
伤好以后，您只能靠着双拐走路了。	Complex 10 12 双拐
总之，凡有一线希望的地方，他都去过了。	Complex 5 9 一线希望
祖父发现我铲的那块地还留着一片狗尾草，就问我：“这是什么？”	Complex 5 6 铲
他非常愿意彻夜不睡，同这样的看守共度通宵；他愿意跟他们逗趣戏谑，给他们讲他漂泊生涯的故事，然后又悉心倾听他们的趣闻，目的只有一个：使他们保持清醒，以便让他们始终看清，他在笼子里什么吃的东西也没有，让他们知道，他们之中谁也比不上他的忍饿本领。	Complex 37 39 漂泊
这位宋朝的隐士林和靖，妻梅子鹤，终老是乡，范仲淹曾赞美他“片心高与月徘徊，岂为千钟下钓台。	Hard 37 44 岂为千钟下钓台
细娃们都像喝了碗凉水，心里格外舒畅，一齐喊叫道：“该背时！	Hard 0 2 细娃
我乘她不再紧接的问，迈开步便走，匆匆的逃回四叔的家中，心里很觉得不安逸。	Hard 33 35 安逸
其实也不尽然。	Complex 3 6 不尽然
一年过去了，六个矮儿子回来了。	Complex 8 9 矮
通讯也好，还有赵望云的风俗画。	Complex 11 14 风俗画
有横在溪水上的独木桥,有下面可以走船的石拱桥,有舟船相连再铺上木板的浮桥,有跨过大江大河的斜拉桥……	Complex 19 22 石拱桥
到晚上，他就穿上宽大的羊皮袄，敲着梆子，在别墅的周围走来走去。	Hard 17 19 梆子
你看,在商店的橱窗里,在百姓的客厅中,在机关单位的大门口；在欢庆申奥成功的人群中,在归国旅游的白发苍苍的老华侨胸前,甚至在孩子们的颈上；在首都北京,在西南的少数民族的村寨,到处都可以看到中国结那富于丝绸质感的鲜红、美丽、典雅的造型。	Complex 83 85 村寨
这位科学巨匠就是这样，但这在他身上远不是主要的。	Complex 4 6 巨匠
船有节奏地前后晃荡着。	Complex 7 9 晃荡
波农丁皱着眉头，伤感地说：“它要离开我们去象冢了。”	Hard 21 23 象冢
说完，小兔为塘鹅妈妈表演了一个大倒立，可是塘鹅妈妈只是点了点头。	Complex 21 23 塘鹅
少焉，月出寒阴，微明散布石上，松声倏然自万壑来，客皆悚视寂，觉境愈清，思愈远。	Hard 8 14 微明散布石上
中国古代哲人早就看到大自然运行的一条重要规律，并由此引申出人生的准则：“天行健，君子以自强不息。”	Hard 36 39 天行健
这所谓灵柩，其实只是一卷用绳子捆着的芦席，说书人的脚从席子里露出来，不住随着杠手的步骤摆动，他的破长衫的一角直垂到地上，一路上扫着路上的浮土。	Complex 41 43 步骤
但是在阜平，这样一身衣服，织染既是不容易，穿上也就觉得鲜亮好看了。	Complex 3 5 阜平
英国足球协会的成立标志着现代足球运动的诞生。	Complex 19 21 诞生
董奉又把用杏子换来的米，救济貧苦的农民。	Complex 12 14 救济
而今，伊拉克境内的古城旧地，除了荒沙和盐碱地，再也找不到当年古文明美丽的环境。	Complex 9 13 古城旧地
中国婚姻方法的缺陷，才子佳人小说作家早就感到了，他于是使一个才子在壁上题诗，一个佳人便来和，由倾慕——现在就得称恋爱——而至于有“终身之约”。	Complex 44 45 和
我在花园里踱来踱去，一阵微风吹来时，我发现一件奇妙的事：白杨树上完全成熟了的柔荑花绽裂开来，随风飘荡，它的包着种子的绒毛到处飞舞，像雪花似的飞满天空，把泥地和整个院子都铺满了；漫天飞舞着银白色的绒毛，这景象多么神奇！	Complex 5 9 踱来踱去
爸爸不愧是作家，跟自己的亲骨肉也咬文嚼字，而且也不肯赏一句振奋人的话。	Hard 16 20 咬文嚼字
不久，英国政府采纳了罗兰希尔的建议，批准了世界上第一种邮资凭证——邮票，规定信件不超过半盎司（相当于14克），收费1便士。	Hard 58 60 便士
我只好解开重扣，爸爸说还要加上14秒时间，这样，我就降为第三名了。	Hard 5 7 重扣
雨小了些，祥子微微直了直脊背，吐出一口气：“先生，避避再走吧！”	Complex 12 14 脊背
后来，有一位喇嘛对国王献计：“除非找来九色鹿的皮做褥子，角做汤膏，才能使妃子睡了褥子醒神，吃了汤膏去祛病，否则必死无疑。”	Complex 30 32 汤膏
但自从被《申报》重金礼聘去当总编辑以后，也许是四为报受到立完派的张謇等影响过多、控制过严吧，他以“冷”的署名写的“时评”和“小言”，吞吞吐吐，有时简直不知所云，真如一般人批评的，看了像读《太上感应篇》一般，《时事新报》有署名“东荪”的评论，似乎言之有物，但文词啰嗦，不着边际。	Hard 32 34 张謇
此时，我简直是悲哀至极，哪里还有什么闲情逸致来欣赏幽径的情趣呢？	Complex 25 27 幽径
这里“霏”和“开”押韵（不完全韵），“空”和“形”押韵（不完全韵），“摧”和“啼”押韵（不完全韵），“讥”和“悲”押韵，“明”、“惊”和“顷”、“泳”、“青”押韵（平仄通押），“璧”和“极”押韵，“忘”和“洋”押韵。	Hard 82 86 平仄通押
离窠外出寻找花蜜的单个蜜蜂(根据一个跳舞的小蜂给它的指令：“去南偏东南七百米，有苜蓿——注意根据太阳偏转调整方向”)仍然是如同有细丝系住一样属于蜂窠的一部分。	Hard 40 42 苜蓿
这个计划建立的“工作框架图”所提供的序列，经生物信息的加工与其他技术的研究，已鉴定了近4万个基因，而且已经克隆了几十种与疾病直接有关的“疾病等位基因”。	Hard 53 55 克隆
我把脸伏在母亲的胸前，委屈地抽噎着。	Hard 14 16 抽噎
元英宗十分向往贞观年间君臣相得的情景，问身边的大臣拜住：“今天可还有魏徵那样敢说话的人？”	Hard 25 27 拜住
“多利”不是由母羊的卵细胞和公羊的精细胞受精的产物，而是“换核卵”一步一步发展的结果，因此是“克隆羊”。	Hard 20 22 受精
我们下一代——眼睛明亮、嗓音稚嫩、脸颊透红的下一代，将在化学废料中学游泳，他们的血管里将流着我们都说不出来的毒素。	Complex 14 16 稚嫩
徐霞客的时代，没有火车，没有汽车，没有飞机，他所去的许多地方连道路都没有，加上明朝末年治安不好，盗匪横行，长途旅行是非常艰苦又非常危险的事。	Complex 50 52 横行
白鹭是一首精巧的诗。	Complex 0 2 白鹭
一行人都吃得饱了，在厅上拜辞了梁中书。	Complex 12 14 拜辞
小刺猬连忙从背上取下两个大苹果，对小獾说：“留下吧，这也是我的一点儿心意！”	Hard 18 19 獾
然而不行，寒气从大衣的破洞侵入，像是一些刁滑、顽强的小动物，很快就爬满全身，他觉得自己也像是跌进了那冰冷的洪水中，怎样挣扎也抓不到一件可以依附的东西。	Complex 20 22 刁滑
也许是在为自己的“早晚”这一信念而进行的搏斗中，溪水分道扬镳了：一部分水说，这一条路会早一点儿到达目的地，而另一部分水认为另一边是近路，于是它们分开来了，绕了一个大弯子，彼此之间形成了一个大孤岛。	Complex 26 30 分道扬镳
老都管道：“你们不要怨怅，巴到东京时，我自赏你。”	Hard 13 14 巴
“没有人应该因镭致富，镭是一种元素，它是属于全世界的。”	Hard 7 8 镭
这时，我们不由得心潮澎湃，思绪万千，上下几千年，纵横千万里，一下涌进脑海之中，真是“无限风光在险峰”啊！	Complex 24 26 纵横
更羸说：“请让我试一下。”	Hard 0 2 更羸
水蒸气遇到冷，凝成了无数小水滴，漂浮在空中，变成云。	Complex 16 18 漂浮
这一事实会勾销了它仅仅剩下的那一点虚名，全部否定了它在品德方面具有诱导的作用，因为，这一来连那些懒汉也开始犹豫，再不肯向它学习了。	Complex 5 7 勾销
它们将短硬的喙像北方农妇在缸沿砺刀那样，在枝上反复擦拭。	Hard 6 7 喙
过去咱们阿尔萨斯最大的不幸，就是把教育推延到明天。	Complex 4 8 阿尔萨斯
小山谷里稻浪推涌，美好的稻香翻腾着。	Complex 14 16 翻腾
那人慢慢地站起来，手里拄着一根桦木削成的棍子，微风吹着他颤颤摇摇的身体，似乎一根根筋骨都能从衣服外面数出来。	Complex 15 17 桦木
大火连烧三天，烟云笼罩了整个北京城。	Complex 9 11 笼罩
每当读到“独在异乡为异客，每逢佳节倍思亲”“春草明年绿，王孙归不归”“自在飞花轻似梦，无边丝雨细如愁”之类的句子，常会有一颗两颗冰凉的泪珠落在我的腮边、手背。	Complex 35 42 自在飞花轻似梦
屠格涅夫也常常带来一些外文书籍，并非常流利地翻译一些歌德和普希金的诗句。	Hard 29 32 普希金
汽车行驶了大约三英里时，我们发现路边有条大黄狗，它似乎等着我们的到来。	Hard 8 10 英里
像西沙群岛上更有许多堆积得很厚很紧的鸟粪层，是极好的肥料，一种特别的矿产。	Complex 18 21 鸟粪层
我心悦诚服地点着头，感到这山民的几句朴素的话，似科包蕴着意味深长的哲理。	Complex 1 5 心悦诚服
那大圣趁着机会，滚下山崖，伏在那里又变，变了一座土地庙儿，大张着口，似个庙门，牙齿变做门扇，舌头变做菩萨，眼睛变做窗棂。	Complex 57 59 窗棂
苦苦寻觅中诞生了第三个方案。	Complex 0 4 苦苦寻觅
每个人都必须竭尽全力，否则就要前功尽弃。	Complex 6 10 竭尽全力
田间与灌木篱下，横陈着田凫、椋鸟、画眉等数不清的腐鸟的血衣，鸟儿的肉已被隐秘的老饕吃净了。	Hard 11 13 田凫
大自然这番壮美的景象，引起了鲁迅美好的回忆和辽远的退想。	Hard 25 27 退想
我听得斋公们说：打了天上的星宿，阎王就要拿去打一百铁棍，发在十八层地狱，永不得翻身。	Hard 3 5 斋公
最年轻的姑娘侬香得知了杀死火魔的秘密。	Complex 16 18 秘密
一九二0年有一天，堂兄兴高采烈地对我讲：“中国出了个了不起的英雄，真是神机妙算，用兵如神。”	Complex 11 15 兴高采烈
须知著书固要智慧，读书也要智慧。	Hard 2 4 著书
“我需要一克镭，以便继续我的研究，但是我买不起，的价格太高了。”	Hard 6 7 镭
医生刚一离开，这位病人就十分痛苦地挣扎着，用一只胳膊支起了身子，口中气喘吁吁。	Complex 17 19 挣扎
如果我一直不长大，就可一直沉浸在雨的欢乐中。	Complex 13 15 沉浸
记得有一个夏天的深夜，我忽然从睡梦中醒了过来，因为我的床背就紧接着母亲的床背，所以从帐里望得见母亲独自一人在灯下做鞋底，我心里又想起母亲的劳苦，辗转反侧睡不着，很想起来陪陪母亲。	Complex 72 76 辗转反侧
我把那件印着骄傲的仰着头的大角麋鹿的运动衫放在柜台上，抱着鞋盒走出商店。	Hard 15 17 麋鹿
一天，正值黄梅时节，天气闷热，王冕放牛累了，便在绿草地上坐着。	Hard 5 9 黄梅时节
云雾弥漫山谷，它是茫茫的大海；云雾遮挡山峰，它又是巨大的天幕。	Complex 28 30 天幕
毒牙是空心的，就像一支快速注射的针头，毒液传送到齿尖，可以让一个大动物几分钟之内昏迷——不喜欢有失身份的搏斗，蛇从不过多支付体力上的代价。	Complex 52 54 搏斗
新式构造，用不着争座位，便放了心，延宕到九点钟才去，谁料照例，人都满了，连立足也难，我只得挤在远处的人丛中看一个老旦在台上唱。	Complex 28 30 照例
这所谓灵柩，其实只是一卷用绳子捆着的芦席，说书人的脚从席子里露出来，不住随着杠手的步骤摆动，他的破长衫的一角直垂到地上，一路上扫着路上的浮土。	Hard 38 40 杠手
我们把新怀疑主义带进了所有的课堂，给那些不习惯质疑的老师带来了烦恼。	Hard 4 8 怀疑主义
“你瞧瞧，”他摇晃着脑袋对另一个人说，“你瞧，他们干得多利落！”	Complex 28 30 利落
《千家诗》中很大一部分诗歌歌咏祖国风物，按春夏秋冬时序编排，打开书往下念，四季风光就活生生地展现在眼前：“成紫千红总是春”，“春城无处不飞花”；“绿树阴浓夏日长”，“五月榴花照眼明”；“青女素娥俱耐冷，月中霜里斗婵娟”；“梅雪争春未肯降，骚人搁笔费评章”……	Hard 111 118 梅雪争春未肯降
来到这座城市，展现在救援队员面前的是一片悲惨景象：房倒屋塌，失去亲人的大人、孩子在哭泣，空气中弥漫着尸体腐烂后荼发的臭气。	Hard 55 57 荼发
他们纳粮当兵，敬畏官吏，何负于晋？	Hard 12 16 何负于晋
起初，肯尼迪家族在一大群应选的一流建筑师中，并没有太注意贝聿铭这位“初生之犊”，但他在生动地描述了根据建筑场地所作的设计，建筑材料的选用，以及如何赋予这座建筑物以特殊的目的和意义之后，深深地获得了肯尼迪遗孀杰奎琳的赏识。	Complex 103 106 杰奎琳
血和惨叫使整个工房的人都怔住了，大家都在发抖，这好像真是一个榜样。	Hard 12 13 怔
果一变变作个鱼鹰儿，飘荡在下溜头波面上。	Hard 13 16 下溜头
飞机在高空盘旋，鲜花伴着骨灰，撒向无垠的大海。	Hard 17 19 无垠
有弗学，学之弗能弗措也；有弗问，问之弗知弗措也；有弗思，思之弗得弗措也；有弗辨，辨之弗明弗措也；有弗行，行之弗笃弗措也。	Hard 16 23 问之弗知弗措也
水要喷出来，或者身体哪里破了流血，它立即上去按住；护士给病人打针时它要负责把注射液推入人体；握扫帚把柄时，它要独当一面；攥、捏、握、捻、弹、揪都离不开它。	Hard 60 61 攥
有些恶客在朋友家发现一本好书，顿时暗起杀机，雀跃曰：“哎呀，老哥，借给俺瞧瞧！”	Complex 17 21 暗起杀机
这样，大自然布置完毕，显然满意了，因此它在自己的这件艺术品上，最后三下两下，将那些可以让人从人间步人胜境去的通道全部切断，处处悬崖绝壁，无可托足。	Complex 63 67 悬崖绝壁
天保恰好在那天应向上行，随了陆路商人过川东龙潭送节货，故参加的就只傩送。	Hard 33 35 傩送
这种新物质的放射性极强，极少量的镭散布在矿石中，就是一些触目的现象的来源，很容易观察或测量。	Hard 16 17 镭
这支在滔滔海浪中前进的庞大舰队，前后绵延十几里，风帆蔽空，战旗招展。	Complex 18 20 绵延
从破屋顶的窟窿里看得见椽子。	Hard 11 13 椽子
及至始皇，奋六世之余烈，振长策而御宇内，吞二周而亡诸侯，履至尊而制六合，执敲扑而鞭笞天下，威振四海。	Hard 36 39 执敲扑
从物候学的角度来说，这首在当年就很轰动的诗，表现了两个重要规律：第一，草木的茂盛和凋谢，有一年一度的循环的规律；第二，这循环是随气候转化的，春风一到，头年枯黄的草木就苏醒了。	Complex 41 43 凋谢
不过，别看一丈青大娘能镇八方，她可管不了何满子。	Complex 5 8 一丈青
正是水的不同形态，使我们的地球环境“淡妆浓抹总相宜”，总是那么美丽，充满了生机。	Hard 18 25 淡妆浓抹总相宜
更会有一些农妇听了死讯一时性起，咬牙切齿地憎恨城市，憎恨外出，连带也憎恨信客，把他当做了死神冤鬼，大声呵斥，他也只能低眉顺眼、连声诺诺。	Complex 58 62 低眉顺眼
“你有了什么高招？”	Complex 6 8 高招
在西部有好几处沙疗疗养院。	Hard 7 9 沙疗
城春草木深，孟夏草木长。	Hard 6 10 孟夏草木
缅伯高把鹅从笼里抱出来，鹅已迫不及待要奔向水里。	Complex 0 3 缅伯高
在藏语中，拉萨是圣地的意思，那么，这湛蓝的天就是圣地的窗帘了。	Complex 18 20 湛蓝
啪啪声里，一道道浆，衔接得天衣无缝，刷过去的墙面，真好比平平整整打开一面雪白屏障。	Complex 10 12 衔接
德里莫夫中尉这样坐着，没人认出他来；谈到他自己，却假装是说别人，他越坐得久，他越变得不可能暴露他的身份，不可能站起来说：你们不认识我了么，母亲，父亲，我是个怪样的人了！……	Hard 4 6 中尉
承彦曰：“老夫在小婿家观《梁父吟》，记得这一篇；适过小桥，偶见篱落间梅花，故感而诵之。	Hard 37 42 故感而诵之
他非常愿意彻夜不睡，同这样的看守共度通宵；他愿意跟他们逗趣戏谑，给他们讲他漂泊生涯的故事，然后又悉心倾听他们的趣闻，目的只有一个：使他们保持清醒，以便让他们始终看清，他在笼子里什么吃的东西也没有，让他们知道，他们之中谁也比不上他的忍饿本领。	Complex 5 9 彻夜不睡
“你等着吧，总有一天我要把你从这儿撵走……”	Hard 17 19 撵走
邢夫人苦留吃过晚饭去，黛玉笑回道：“舅母爱惜赐饭，原不应辞，只是还要过去拜见二舅舅，恐领了赐去不恭，异日再领，未为不可。	Hard 25 29 原不应辞
周恩来声音从容柔和：“过澧水不算过长江。	Hard 12 14 澧水
梁思成第一个抓住铁索，两腿悬空地往刹尖攀援。	Complex 13 15 悬空
在极度推崇和广泛使用化学杀虫法的十多年以后，昆虫学家们发现他们以为在几年前就已解决的问题又卷土重来，而且有了新麻烦：刚出现时毫不起眼的某种昆虫会迅速繁衍成灾。	Complex 45 49 卷土重来
我们立即分了工，我去钓鱼，剩下的一个人照料老班长，一个人生火。	Complex 19 21 照料
相传在战国时候，赵国的邯郭人走路的姿势特别优美。	Complex 11 14 邯郭人
忽一日，李小二正在门前安排菜蔬下饭，只见一个人闪将进来，酒店里坐下；随后又一人闪入来。	Hard 23 25 闪将
把椅背放倒，躺下，似睡非睡挨到日没，坐起来，心神恍惚，呆呆地直坐到古祭坛上落满黑暗然后再渐渐浮起月光，心里才有点明白，母亲不能再来这园中找我了。	Complex 22 26 心神恍惚
“大家都在外面等待，准备好了华盖，以便举在陛下头顶上去参加游行大典。”	Hard 14 16 华盖
她拖着铁罐子跑了一天，藏躲在什么地方，终于夤夜又复光临寒舍？	Hard 21 23 夤夜
我们往往还会看到触须的颤抖和触角以及腹肌十分明显的运动：彼此盆开，然后突然并拢。	Complex 14 16 触角
玄德屏人促席而告曰：“汉室倾颓，奸臣窃命，备不量力，欲伸大义于天下，而智术浅短，迄无所就。	Hard 4 6 促席
又如大家所熟悉的范仲淹的《岳阳楼记》：“若夫淫雨霏霏，连月不开。	Hard 20 26 若夫淫雨霏霏
“子在川上曰：‘逝者如斯夫，不舍昼夜。’”	Hard 8 13 逝者如斯夫
其实，它们只不过是受风操纵，让它们躺，它们就得倒，倒的姿势都得由风来决定；叫它们起来，它们就不能趴着，没有一点商量余地；让它们安静它们才能安静，让它们疯狂它们就得疯狂。	Complex 57 59 余地
可惜它们并不真正存在，当彩虹悄然隐去，海市无声消失的时候，人们仍然只能依靠自己的双脚走出戈壁，去寻找活水和黑土，寻找蔚蓝色的大海和坚实的船帆。	Hard 44 46 戈壁
我们鲁镇的习惯，本来是凡有出嫁的女儿，倘自己还未当家，夏间便大抵回到母家去消夏。	Complex 24 26 当家
那大虫咆哮起来，把身底下扒起两堆黄泥，做了一个土坑。	Complex 3 5 咆哮
在朝旭未露前，宛似无量数厚毳长绒的绵羊，交颈接背地眠着，卷耳与弯角都依稀辨认得出。	Hard 12 14 厚毳
雨来了，雨来的时候瓦这么说，一片瓦说，千亿片瓦说，轻轻地奏吧沉沉地弹，徐徐地叩吧挞挞地打，间间歇歇敲一个雨季，即兴演奏从惊蛰到清明，在零落的坟上冷冷奏挽歌，一片瓦吟千亿片瓦吟。	Hard 40 42 挞挞
这样的“路”，还可以过汽车——汽车吼叫着，车身摇晃着，卵石挤碰着，水花四溅，我们的心也怦怦直跳……	Complex 43 47 怦怦直跳
小熊捋下一片小椿树叶。	Hard 6 10 小椿树叶
“天资”，我本来想用“天才”，但天才是个稀见现象，其中不少是“偏才”，所以我弃而不用，改用“天资”，大家一看就明白。	Complex 1 3 天资
另外一个伙计使劲地擤鼻子。	Hard 9 10 擤
卖杨梅的都是苗族女孩子，戴一顶小花帽子，穿着扳尖的绣了满帮花的鞋，坐在人家阶石的一角，不时吆唤一声：“卖杨梅——”，声音娇娇的。	Complex 45 47 吆唤
只有那些正在候补朝廷中的重要官职和希望得到皇帝宠幸的人才来表演这种技艺。	Complex 23 25 宠幸
这样一来，我心中的疑云一扫而光：池塘中生长的真正是洪湖莲花的子孙了。	Complex 9 11 疑云
但看她模样还周正，手脚都壮大，又只是顺着眼，不开一句口，很像一个安分耐劳的人，便不管四叔的皱眉，将她留下了。	Complex 6 8 周正
这天晚上，草地篝火旁多了些生机。	Complex 7 9 篝火
例如《诗经·鲁颂》的《駉》这一首诗里提到马的名称就有16种：“驈”(身子黑而胯下白的)，“皇”(黄白相间的)，“骊”(纯黑色的)，“黄”(黄而杂红的)，“骓”(青白杂的)，“駓”(黄白杂的)，“騂”(红黄色的)，“骐”(青黑成纹像棋道的)，“驒”(青黑色而有斑像鱼鳞的)，“骆”(白马黑鬃)，“駵”(红马黑鬃)，“雒”(黑马白鬃)，“駰”(灰色有杂毛的)，“騢”(红白杂毛的)，“驔”(小腿长白毛的)，“鱼”(两眼旁边毛色白的)。	Hard 31 32 驈
宋代理学家陆象山的语录中说：读书且平平读，未晓处且放过，不必太滞。	Complex 14 20 读书且平平读
沙子在屋子里弥漫飞扬，躲进被子里上不来气儿，露出脑袋更被黄沙呛得窒息。	Complex 6 10 弥漫飞扬
中华鲟生活在江河里，最大的可以长到五百千克重。	Hard 0 3 中华鲟
至于白花，那是因为细胞液里不含色素的缘故。	Complex 15 17 色素
洗三那天，亲手杀了一只羊和三只鸡，摆了个小宴；满月那天，更杀了一口猪和六只鸭，大宴乡亲。	Complex 0 2 洗三
水正在结冰，人们可以听到冰块的碎裂声。	Complex 15 18 碎裂声
我原说过写包票的！"	Complex 5 7 包票
一天，正值黄梅时节，天气闷热，王冕放牛累了，便在绿草地上坐着。	Complex 15 17 王冕
母亲是个很顾脸面的人，每次向邻居家借钱，都需鼓起一番勇气。	Complex 5 8 顾脸面
自既望以至十八为最盛。	Hard 1 3 既望
1940年，美国著名黑人歌唱家保罗·罗伯逊热情地唱起这首歌，并灌制了唱片a于是，这首歌文传遍世界，成为世界反法西斯战线s首高昂的战歌。	Complex 31 33 灌制
当日林如海教女以惜福养身，云饭后务待饭粒咽尽，过一时再吃茶，方不脾胃。	Hard 13 16 云饭后
渔夫一边把胆瓶挪近岸边，准备扔到海里去，一边说，“我要把你扔到海里，你说你在海里已经待过一千八百年，这一回我非叫你在海里待一辈子不可。	Complex 5 7 胆瓶
他没有把面包送给德国兵，而是送给了俄国兵，因为他的飞机被强迫降落了。	Complex 28 32 强迫降落
俺只道那个郑大官人，却原来是杀猪的郑屠。	Complex 17 19 郑屠
哪里有洪水，哪里就有军旗飘扬；哪里有危险，哪里就有军徽闪烁。	Hard 25 29 军徽闪烁
据姐夫来信说，他看了这句话，先是大笑，然后跑进洗手间，拿起一块毛巾捂住了脸。	Complex 33 34 捂
冰雪融化，草木萌发，各种花次第开放。	Hard 13 15 次第
裸子植物的花是原始的形态，都带绿色，而花药和花粉则呈黄色。	Hard 0 4 裸子植物
普罗米修斯忍受了这一切苦痛而不哼一声，绝不祈求宙斯仁慈，绝不对自己做过的事说一句懊悔的话。	Complex 40 42 懊悔
有的队员用声波探测仪仔细搜索着每一条缝隙，细心地捕捉着废墟里发出的声音；有的队员操作液压钳，剪断纵横交错的一根根钢筋，搜寻着压在废墟下的幸存者……	Complex 27 29 废墟
先在东三省立了个小宣统的满洲国，又在口外立了个德王的蒙疆政府，往后没有殷汝耕的公文护照，不许出口一步。	Hard 8 11 小宣统
纳米技术就在我们的身边。	Complex 0 4 纳米技术
把那些不是亲手做的皮靴陈列在自己的店里，他是决不能容忍的。	Complex 11 13 陈列
可是，出乎预料的是，小姑娘竟学着萧伯纳的口吻说道：“请你回去后告诉你妈妈，就说今天同你玩的是苏联小姑娘娜塔莎。”	Hard 51 54 娜塔莎
既然是夜间，各种色相都隐退了，一切色彩斑斓的词汇也就失去了效能；又在下雨，空间十分逼仄，任何壮举豪情都铺展不开，诗句就不能不走向朴实，走向自身，走向情感，李商隐著名的《夜雨寄北》堪称其中典范。	Complex 11 13 隐退
有弗学，学之弗能弗措也；有弗问，问之弗知弗措也；有弗思，思之弗得弗措也；有弗辨，辨之弗明弗措也；有弗行，行之弗笃弗措也。	Hard 28 35 思之弗得弗措也
玄德屏人促席而告曰：“汉室倾颓，奸臣窃命，备不量力，欲伸大义于天下，而智术浅短，迄无所就。	Hard 40 44 迄无所就
回来的路程危险增加了十倍，在前往极点的途中只要遵循罗盘的指引，而现在他们还必须顺着自己原来的足迹走去，在几个星期的行程中必须小心翼翼，绝对不能偏离自己原来的脚印，以免错过事先设置的贮藏点——在那里储存着他们的食物、衣服和凝聚着热量的几加仑煤油。	Hard 117 119 加仑
但我更不忍心破坏她的梦。	Complex 3 6 不忍心
它不仅仅成了波兰人朝拜的圣地，举行精神宴会的殿堂，参观游览的古迹，而且为数众多的外国音乐家、钢琴家、作曲家都把造访这个伟大艺术家的摇篮、这个喷射出了肖邦伟大音乐的不竭源泉，看成自己一生的夙愿。	Hard 93 95 夙愿
在美国，以快捷、价廉取胜，并被大众所广泛接受的麦当劳，虽然在北京也受到了热烈的欢迎，但其中被赋予的意义与其美国祖源地却有很大的不同。	Hard 55 58 祖源地
二人对坐于林间石上，关、张侍立于侧。	Hard 13 17 侍立于侧
我所说的是否与《礼记》《老子》原意相和，不必深求；但我确信“敬业乐业”四个字，是人类生活的不二法门。	Complex 45 49 不二法门
他说道，“但有一个条件：如果你不能在当天返回出发地点，你就将白白失去那一千卢布。”	Hard 37 39 卢布
如果我们觉得不堪生之重压而白白虚度此生，那也只能怪我们自己。	Complex 6 8 不堪
唐僧一见，惊得从马上摔下来，坐在地上，不由分说，一口气念了二十遍紧箍咒。	Complex 32 35 紧箍咒
蓝天、骄阳、绿树、红土、鲜花，以及皮肤油黑发亮的非洲人，构成了七彩的非洲！	Complex 19 23 油黑发亮
这儿应该有几声胡笳和羌笛的，音色极美，与自然浑和，夺人心魄。	Complex 10 12 羌笛
昨晚上我们两口子本来是商量好，说得一妥百妥，决不留恋孩子啦，可是，正因为她太小，所以总担心她是不是这样那样啦，结果是我们两口子一夜没睡。	Complex 24 26 留恋
它犹如一条巨龙，穿崇山峻岭，越草原戈壁，过盐湖沼泽，奔腾在莽莽的“世界屋脊”上。	Complex 21 25 盐湖沼泽
今诸君苟不于此时植其基，勤其学，则将来万一因生计所迫，出而仕事，但任讲席，则必贻误学生；置身政界，则必贻误国家。	Hard 22 26 生计所迫
人们在高峰之上，如登仙界云霄，轻盈的云雾忽东忽西，一上一下，若即若离，仿佛是山峦、峰石的恋人，难舍难分。	Complex 12 14 云霄
莲心里含有莲心碱、荷叶碱、木犀草甙、金丝桃甙等，有强心和降血压的功效。	Hard 18 22 金丝桃甙
怀疑可以使我们摆脱幻想，还可以检验我们的推测。	Complex 20 22 推测
少停，外边先传进一阵敲门的声音，接着走进一男一女，男的一望而知是一个警察，女的一手提了一个小包袱，从她可怜神情，也不难猜出，她就是闯了祸的李嫂。	Hard 0 2 少停
柏杨先生于是建议，应该组织一个“借书必还大联盟”，盆中歃血，对天立誓，誓曰：“借书不还，天打雷劈。”	Hard 27 29 歃血
每天舞蹈般婆娑变化的只是远远近近的游云，颜色也变幻莫定。	Hard 5 7 婆娑
它也可能是比较急促的号子，那是纤夫在吼，他们拉纤逆流而上，如果拉的是小木船，也许就只五六个人，如果拉的是扬着横帆的大船过急滩，那就要两百来人。	Complex 15 17 纤夫
刘姥姥又给贾母辞行，鸳鸯将众人送她的几大包东西给她，叫了车，让小厮送刘姥姥回乡下去了。	Hard 10 12 鸳鸯
扫开一块雪，露出地面，用一枝短棒支起一面大的竹筛来，下西撒些秋谷，棒上系一条长绳，人远远地牵着，看鸟雀下来啄食，走到竹筛底下的时候，将绳子一拉，便罩住了。	Complex 73 74 罩
如果所有的动物都死去了，人类也会灭亡。	Complex 16 18 灭亡
而我们的诗人杜甫，却宁可冒这危险，创造出那千古流传形象鲜明的诗句；这冒险，这形象，其实又都在这一个“木”字上，然则这一字的来历岂不大可思索吗？	Complex 67 69 思索
批评批判汉语最初二者相通，即评论之义，如说金圣叹批、眉批等等，就是指评论，包括褒奖也包括指责，当然更包括解释与分析。	Complex 26 28 眉批
爸爸说：“近年来回国旅行的美国华侨络绎不绝，叔公应该是头一个踏上旅程的。	Hard 15 17 华侨
如果我不去剪除这一个戕害天性的蟊贼，让他继续为非作恶，岂不是该受天谴吗？	Hard 15 17 蟊贼
圜丘建筑上有一个特点。	Hard 0 2 圜丘
金龟子的折扇，跟天牛长长的须角、锹甲的铁锹般的上颚一样，都是发育成熟可以求偶的标志，只是外形各不相同而已。	Hard 23 25 上颚
倘若被海水冲走，也能在海水中漂流上两三个月，遇到海滩照样扎根生长。	Complex 0 2 倘若
老杜有一句诗：“四更山吐月，残夜水明楼”，后代的诗人特别喜欢。	Hard 14 19 残夜水明楼
两只汗流浃背的蚂蚁若有所思，把它检看了一阵，认为干蚱蜢腿根本是破烂货，于是它们分道扬镳，看自己能不能找到一根旧钉子，或者其他什么东西，其重量足以让它们进行一番娱乐。	Complex 9 13 若有所思
爸爸竟然也说不出它是什么树，一会儿说是“桧树”，一会又说恐怕是“槭树”，都是奇怪的名称；他只说他小时候就经常来爬它，他们那群小孩子管它叫“大不列颠”，真是莫名其妙。	Hard 20 22 桧树
弗里德里赫国王顿时笑容尽敛。	Complex 0 5 弗里德里赫
可是，他们抬头一看，大雁早已飞得无影无踪了。	Complex 16 20 无影无踪
有人说这蘸浆的手臂悠然摆来，悠然摆去，好赛伴着鼓点，和着琴音，每一摆刷，那长长的带浆的毛刷便在墙面“啪”的清脆一响，极是好听。	Hard 19 21 好赛
又如大家所熟悉的范仲淹的《岳阳楼记》：“若夫淫雨霏霏，连月不开。	Hard 27 31 连月不开
“你要知道，”魔鬼说，“我是个无恶不作的凶神，曾经跟所罗门作对，他派人把我捉去，装在这个胆瓶里，用锡封严了，又盖上印，投进海里。	Complex 26 29 所罗门
翻开一部《辞源》或《辞海》，金木水火土，各成世界，而一入“雨”部，古神州的天颜千变万化，便悉在望中，美丽的霜雪云霞，骇人的雷电霹雹，展露的无非是神的好脾气与坏脾气，气象台百读不厌门外汉百思不解的百科全书。	Hard 53 57 霜雪云霞
擂鼓打锣的，多坐在船只的中部，船一划动便即刻蓬蓬铛铛把锣鼓很单纯的敲打起来，为划桨水手调理下桨节拍船快慢既不得不靠鼓声，故每当两船竞赛到剧烈时，鼓声如雷鸣，加上两岸人呐喊助威，便使人想起小说故事上梁红玉老鹳河时水战擂鼓种种情形。	Complex 0 4 擂鼓打锣
这个计划建立的“工作框架图”所提供的序列，经生物信息的加工与其他技术的研究，已鉴定了近4万个基因，而且已经克隆了几十种与疾病直接有关的“疾病等位基因”。	Hard 18 20 序列
六岁的小女孩柔弱的身体成了黑脸大汉手中一块生面团，翻过来、椆过去、立起来、横过去，抻、拉、压、拽，为所欲为，奶奶看不过我被整得满脸的泪水和汗水，每次都目不忍视地躲到里屋。	Hard 41 42 抻
忙了整整一天，给鸭们围了一个鸭栏，也为他们自己搭了一个小窝棚。	Complex 28 30 窝棚
在奇光异彩交相辉映中，众多的龙舟如银河流星，顺河而下，千姿百态，令人叫绝。	Complex 34 36 叫绝
面对挑战，根据河流动力学，设计提出开挖内河，满足过洪断面要求，使原江岸上的古榕和水塔形成岛屿，保住了几十年的自然遗产，同时在空间上形成了另一层次，丰富了公园的景观。	Complex 9 12 动力学
走过月光闪闪的溪岸，走过石拱桥;走过月影团团的果园，走过庄稼地和菜地……	Complex 7 9 溪岸
只见海参在海底懒洋洋地蠕动着。	Complex 7 10 懒洋洋
据我观察，人在年轻时多半是富于理想的，随着年龄增长就容易变得越来越实际。	Complex 13 15 富于
既然已经不能改正，索性也就听之任之。	Complex 13 17 听之任之
拉头大喊了一声，这么一来，那鬼影真就不动了。	Hard 0 2 拉头
往常，开始上课的时候，教室里总是一片乱哄哄，街上都听得见，课桌开开关关，大家一起高声诵读，你要专心，就得把耳朵括捂起来，老师用大戒尺不停地拍着桌子喊道：	Complex 42 44 诵读
玛丽的性格里天生有一种更可贵的东西，她坚定、刚毅、顽强，有远大、执著的追求。	Complex 22 24 刚毅
罗汉就塑得比孩子们高得多，虽然不过是上小下大的一堆，终于分不清是壶卢还是罗汉；然而很洁白，很明艳，以自身的滋润相粘结，整个地闪闪地生光。	Hard 32 34 壶卢
总之，我们大家都感觉到，我们所做的一切得到了最大的报偿。	Complex 25 27 报偿
和风吹送，翻起了一轮一轮的绿波，——这时你会真心佩服昔人所造的两个字“麦浪”，若不是妙手偶得，便确是经过锤炼的语言的精华。	Complex 52 54 锤炼
他喊道，“一匹马，就因为这一匹马，我的国家倾覆了！”	Complex 21 23 倾覆
设有一对夫妇，他们患有不育症，虽然现在不育症可以用人工授精（男方不育）、体外受精（女方不肯）或代理母亲（女方不能怀孕）解决，但夫妻双方不愿意，也不愿领养别人的孩子。	Hard 25 29 人工授精
但她大概也即觉到了，说道：“像你似的小孩子，长毛也要掳的，掳去做小长毛。	Hard 29 30 掳
最年轻的姑娘侬香得知了杀死火魔的秘密。	Hard 13 15 火魔
曾子还说哩：“任重而道远”，“死而后已，不亦远乎！”	Hard 15 19 死而后已
我想像它看到一只野免，因人类的扩张在平原上已近绝迹的野兔，梭罗在《瓦尔登湖》中预言过的野兔：“要是没有兔子和鹧鸪，一个田野还成什么田野呢？	Hard 54 56 鹧鸪
凤姐夹了些茄鲞送入刘姥姥口中，笑道：“你们天天吃茄子，也尝尝我们这茄子，弄得可口不可口。”	Hard 5 7 茄鲞
而最终又可能在这泛滥的思潮中流变出某种生活或事业的蓝图，甚至能明了这蓝图实施中的难点易点以及它们的总体进程。	Complex 14 16 流变
不信，你注意一下自己右手中指的左侧，由于握笔的压力和磨擦，那里就生出了茧子。	Complex 26 28 磨擦
“他多年出门，统忘却了。	Hard 7 8 统
三人冒雪走到卧龙冈，刘备轻叩柴门，开门的还是上回那个书童。	Complex 12 14 轻叩
袁隆平先生是世界杂交水稻的创始人，是世界杂交水稻之父。	Complex 20 24 杂交水稻
他一边放东西，一边对我们又抱歉又诉苦，一边还喘息地喝着水，同时还从怀里掏出一包饭团来嚼着。	Complex 42 43 嚼
如果我们把这种具象化的旅行，抽象化为人生的旅途，我们不分彼此，都是苦旅者。	Complex 7 10 具象化
有一天，古登贝尔克半开玩笑地自言自语道：“是不是可以在几个硬币打制器上加上葡萄压榨机的压力，使之在纸上打印出印花来呢？”	Complex 31 34 打制器
所以像王思任写晚霞那样感性恣纵的杰作，在明清的文坛简直不作第二人想。	Hard 13 15 恣纵
在奥斯维辛，没有新鲜东西可供报道。	Complex 14 16 报道
妖魔鬼怪们听说森林王国的树木都砍光了,高兴得手舞足蹈,一个个跃跃欲试,要去那里逞逞威风。	Complex 30 34 跃跃欲试
小公鸡又喔喔喔地叫起来。	Complex 4 5 喔
兀自不快下拜，等几时！	Hard 0 6 兀自不快下拜
我们要让我们的民族在千年长途的风霜满面中有少年精神，在朝九晚五的风尘仆仆中有做梦的机会，那么，就让我们的下一代多读唐诗吧！	Complex 15 19 风霜满面
卫老婆子仿佛卸了一肩重相似的嘘一口气，祥林嫂比初来时候神气舒畅些，不待指引，自己驯熟的安放了铺盖。	Complex 40 42 驯熟
故尧舜一日万机，文王日晷不暇食，仲尼终夜不寝，颜子欲罢不能，自此以下莫敢淫心舍力，故曰自强不息矣。	Hard 10 15 日晷不暇食
他毕生的真正使命，就是以这种或那种方式参加推翻资本主义社会及其所建立的国家设施的事业，参加现代无产阶级的解放事业，正是他第一次使现代无产阶级意识到自身的地位和需要，意识到自身解放的条件，这实际上就是他毕生的使命。	Complex 23 27 资本主义
写到这里，不由吐了吐舌头，因为北大老师们的紧像，也一视同仁地留在了我的写生画册上：有的绅士风度，有的和蔼可亲，这个怪癖，那个潇洒，或手谈笑风生间“樯橹灰飞烟灭”，或于古朴凝重之中‘形成另一番风格……	Hard 73 79 樯橹灰飞烟灭
读到“青枫江上秋帆远，白帝城边古木疏”，就是一幅清淡的水墨画了，秋风送远了帆影——跟好朋友分别，心里是多么难舍啊！	Complex 37 39 帆影
吃饭时让它坐在旁边，用羹匙喂它；当我把什么东西抹到它嘴上时，它那张小脸儿十分逗人，简直像活了似的。	Hard 11 13 羹匙
真正使贝聿铭声名远扬、跻身世界级建筑大师行列的，是约翰·肯尼迪图书馆的设计和建造。	Complex 11 13 跻身
在风雨如晦的时刻，我踏着那村里的人们也踏过的土地，觉得彼此相隔虽然将及一世纪，但在生命的深处，却和他们有着意味不尽的关连。	Complex 53 57 意味不尽
我非常喜爱田野漫步和户外运动。	Complex 7 9 漫步
母亲站在阳台上，从那里瞅着我们，直到瞅不见为止。	Complex 18 19 瞅
古代中国人，以“阴”“阳”昭示自然万物，表达对世界朴素而深邃的理解。	Complex 28 30 深邃
看着她，让人隐隐心疼。	Complex 6 8 隐隐
“喂，三颗钮扣，请你开开门！”	Hard 3 5 三颗
这篇敷文有更深的含ス。	Hard 2 4 敷文
忽见一人，容貌轩昂，丰姿俊爽，头戴逍遥巾，身穿皂布袍，杖藜从山僻小路而来。	Hard 17 20 逍遥巾
然后每天站在虱子旁边，聚精会神地盯着它。	Hard 6 8 虱子
他用的是一盆不冷不烫的温吞水，外加一条遮眼蔽耳的大毛巾，给我们慢慢洗头；他还晓得我们都喜欢花花绿绿的色彩，就尽力把我们头上的疮疖涂抹得花团锦簇，让我们出了剃头铺就能直奔玩具店。	Hard 62 64 疮疖
有一天，小刺猬来了，伸出小撅嘴，眨着小眼睛，高高兴兴地吃起来了。	Hard 13 15 撅嘴
郑屠正在门前柜身内坐定，看那十来个刀手卖肉鲁达走到门前，叫声：“郑屠！”	Hard 9 11 坐定
刚才还是晴空万里，转眼之间乌云压顶，大大小小在冰雹劈头盖脸地砸下来。	Complex 13 17 乌云压顶
太阳光经过三棱镜或水滴的折射，会分成红、橙、黄、绿、蓝、靛、紫、七种颜色。	Hard 5 8 三棱镜
李白时代的诗人，既挚恋着四川的风土文物，又向往着下江的开阔文明，长江于是就成了他们生命的便道，不必下太大的决心就解缆问桨。	Hard 9 11 挚恋
独夜卧人静，风涛汹汹，直逼枕簟，鱼龙舞啸，其形声时入梦寐间，意洒然快也。	Hard 13 15 枕簟
小孩子们不能用手指拼字，有时唇读也未能弄明白他们的话，只好依赖手势，每逢我误解了他们的意思，干错了事，他们就会哄然大笑，于是哑剧就得再次从头做起。	Complex 55 59 哄然大笑
梁中书道：“上年费了十万贯收买金珠宝贝，送上东京去，只因用人不着，半路被贼人劫将去了，至今无获。	Hard 11 13 万贯
这时，几十只幼龟已成了嘲鹰、海鸥、鲣鸟的口中之食。	Hard 17 19 鲣鸟
语言跟着思维情感走，你不肯用俗滥的语言自然也就不肯用俗滥的思想情感；你遇事就会朝深一层去想，你的文章也就是真正是“作”出来的，不致落入下乘。	Complex 65 69 落入下乘
洗三那天，亲手杀了一只羊和三只鸡，摆了个小宴；满月那天，更杀了一口猪和六只鸭，大宴乡亲。	Complex 39 43 大宴乡亲
人民币作为在全国流通的货币，设计和印制十分精美，体现着中国自然、社会、历史、文化的特点。	Complex 17 19 印制
我悄悄地披了大衫，带上门出去。	Hard 6 8 大衫
那人因祸得福，赶快一面吃着灵芝草，一面对天盟誓，愿给鹿、鸟永远当奴仆，一辈子伺候他们。	Complex 2 6 因祸得福
“作善降祥”的古训，六朝人本已有些怀疑了，他们作墓志，竟会说“积善不报，终自欺人”的话。	Hard 31 35 积善不报
不更事的勇敢的少年，往往敢于给人解决疑问，选定医生，万一结果不佳，大抵反成了怨府，然而一用这说不清来作结束，便事事逍遥自在了。	Hard 33 35 大抵
就这样，鷸和蚌相持着，谁也不让谁。	Hard 6 7 蚌
鞭炮放过一阵后，用长凳脚绑着的大筒烟火，在敞坪一端燃起了引线，先是咝咝的流泻白光，慢慢的这白光便吼啸起来，作出如雷如虎惊人的声音，白光向上空冲去，高至二十丈，下落时便洒散着满天花雨。	Hard 21 23 敞坪
年复一年，从春流到冬，从冬流到夏，水拼命地工作着，工作着，创造着地球的文明，繁荣着地球的文化。	Complex 38 40 繁荣
说罢，忙走去挑掉一茎。	Complex 6 8 挑掉
至于视觉经验，也都表现得很有动感：写荷花迎风则“红披绿偃，摇荡葳蕤”，写微风拂水则“细生鳞甲”，写流萤则“（幽火）班班，若骇若惊，奄忽去来”，写山则“森森欲下搏人”。	Hard 29 33 摇荡葳蕤
但是，皇帝也迫切需要臣子的智慧，也就是在决策的关头，提出反对的意见，也就是谏。	Hard 37 38 谏
宝玉听了，登时发作起痴狂病来，摘下那玉，就狠命摔去，骂道：“什么罕物，连人之高低不择，还说‘通灵’不‘通灵’呢！	Hard 32 34 罕物
于是六国之士，有宁越、徐尚、苏秦、杜赫之属为之谋，齐明、周最、陈轸、召滑、楼缓、翟景、苏厉、乐毅之徒通其意，吴起、孙膑、带佗、倪良、王廖、田忌、廉颇、赵奢之伦制其兵。	Hard 34 36 召滑
悲痛，悲痛，夹杂着隐忍的积忿。	Hard 12 14 积忿
例如《诗经·鲁颂》的《駉》这一首诗里提到马的名称就有16种：“驈”(身子黑而胯下白的)，“皇”(黄白相间的)，“骊”(纯黑色的)，“黄”(黄而杂红的)，“骓”(青白杂的)，“駓”(黄白杂的)，“騂”(红黄色的)，“骐”(青黑成纹像棋道的)，“驒”(青黑色而有斑像鱼鳞的)，“骆”(白马黑鬃)，“駵”(红马黑鬃)，“雒”(黑马白鬃)，“駰”(灰色有杂毛的)，“騢”(红白杂毛的)，“驔”(小腿长白毛的)，“鱼”(两眼旁边毛色白的)。	Hard 157 158 雒
大熊猫喜欢吃新鲜的竹叶和竹笋。	Complex 12 14 竹笋
自然是江南日暮的雪景；“寒沙梅影路，微雪酒香村”，则雪月梅的冬宵三友，会合在一道，在调戏酒姑娘了；“柴门闻犬吠，风雪夜归人”，是江南雪夜更深人静后的景况；“前村深雪里，昨夜一枝开”，又到了第二天的早晨，和狗一样喜欢弄雪的村童来报告村景了。	Hard 18 23 微雪酒香村
将军既帝室之胄，信义著于四海，总揽英雄，思贤如渴，若跨有荆、益，保其岩阻，西和诸戎，南抚彝、越，外结孙权，内修政理；待天下有变，则命一上将将荆州之兵以向宛洛，将军身率益州之众以出秦川，百姓有不箪食壶浆以迎将军者乎？	Hard 10 12 著于
朋友，从崩溃毁灭中，救出中国来，从帝国主义恶魔生吞活剥下，救出我们垂死的母亲来，这是刻不容缓的了。	Complex 42 46 刻不容缓
《诗·召南·草虫》说：“喓喓草虫，趯趯阜螽。”	Hard 12 16 喓喓草虫
母亲骄傲，腹部的妊娠纹象征孕育和新生；遇害者脖颈上可疑的道道抓痕，身体上深浅不一的刀伤，组成罪孽的恐怖条痕——斑纹无处不在，将两极秘密地衔接，像族徽，凝聚着世袭的生和死，荣与辱。	Hard 46 48 罪孽
宋国有个农夫，他巴望着自己田里的禾苗长得快些，就天天到天边去看。	Complex 8 10 巴望
毛主席笑着说：“快去吧，炊事员还等着你呢。”	Complex 12 15 炊事员
他攀上去之后，其他几个年轻人也一一上去，终于将塔刹的各部尺寸、做法测绘下来。	Hard 23 25 塔刹
于是分头四出，寻黑矮汉，寻梢长大汉，寻头陀，寻胖大和尚，寻茁壮妇人，寻姣长妇人，寻青面，寻歪头，寻赤须，寻美髯，寻黑大汉，寻赤脸长须。	Hard 12 17 寻梢长大汉
无论何时，无论何地，只要忆及那清清爽爽的剪纸声，我的心境与梦境就立刻变得有声有色。	Complex 36 40 有声有色
这样我就能够拍下好几百张由反物质留在云室中的精美照片。	Hard 18 20 云室
宇宙是一个大生命，我们是宇宙大气中之一息。	Hard 18 20 一息
刘姥姥问了大姐儿的生辰，听说是七月初七日，便说就叫巧儿正好，若一时有不遂心的事，必然遇难成祥，逢凶化吉，都从这“巧”字儿来。	Complex 42 46 遇难成祥
杜卡斯说，同时用眼光催着在旁边凝神的普罗科菲耶夫发表意见。	Complex 15 17 凝神
今诸君苟不于此时植其基，勤其学，则将来万一因生计所迫，出而仕事，但任讲席，则必贻误学生；置身政界，则必贻误国家。	Hard 39 41 贻误
他们感谢普罗米修斯从太阳那里带来这份神奇的礼物。	Complex 4 9 普罗米修斯
桐城派的文体以“味淡声希，整洁从容”自矜，也难怪表情较平，节拍较缓。	Hard 18 20 自矜
也许有一天，你们还会继承你们的父母积聚起来的财产——这将意味着，你们得到许多钱，但你们却并不曾为此做了什么事情。	Complex 10 12 继承
我们全体担架队员给你挂匾……	Hard 10 12 挂匾
我从开着的窗子望进去，看见同学们都在自己的座位上了；韩麦尔先生呢，踱来踱去，胳膊底下夹着那怕人的铁戒尺。	Hard 49 51 戒尺
中国的指南针传到西方就成为他们远航殖民扩张的工具。	Complex 17 19 殖民
在古庙中，在名园中，往往都有几棵寿达数百年的藤萝，许多神话故事也往往涉及藤萝。	Complex 36 38 藤萝
在克隆鲫鱼出现之前，英国牛津大学的科学家已经在1960年和1962年，先后用非洲一种有爪的蟾蜍(非洲爪蟾)进行过克隆试验。	Hard 1 5 克隆鲫鱼
李逵也不答应他，便就地下掳了银子，又抢了别人赌的十来两银子，都搂在布衫兜里，睁起双眼说道：“老爷闲常赌直，今日权且不直一遍。”	Hard 57 59 不直
我不能解除他们任何痛苦，只得带着那些妇女，给他们拭脸洗手，能吃得的喂他们吃一点，带着背包的，就给他们换一件干净衣裳，有些还得解开他们的衣服，给他们拭洗身上的污泥血迹。	Complex 73 75 拭洗
我全身用力，肌肉紧张，整个人收缩得像一块铁。	Complex 8 10 紧张
雪还铺在地上，又潮湿，又荒凉；一阵刺骨的寒风吹起他的大衣的衣襟，在他的耳朵里凄惨地号叫着。	Complex 41 43 号叫
人们是熟悉天坛的，但是对于“圜丘”，没有到过北京的人就未必知道了。	Hard 14 16 圜丘
这时候，她就梦想到那些精美的晚餐，亮晶晶的银器；梦想到那些挂在墙上的壁衣，上面绣着古装人物，仙境般的园林，奇异的禽鸟；梦想到盛在名贵的盘碟里的佳肴；梦想到一边吃着粉红色的鲈鱼或者松鸡翅膀，一边带着迷人的微笑听客人密谈。	Complex 56 58 禽鸟
当我不在跑步机上跑的时候，就没有什么力量将我往下拽，也没有什么来压迫我的脊椎。	Complex 24 25 拽
先生莫名其妙，觉得有点奇怪，诸葛亮却暗自得意。	Complex 2 6 莫名其妙
那后来的冰赶上他，只挤得嗤嗤价响。	Hard 12 16 嗤嗤价响
但是对于黄翅飞蝗泥蜂来说，这一切还不足以使猎物无法伤害自己，它还需要紧紧勒住猎物，使之丝毫不能动弹，以便螫针能把毒汁注入要刺的地方；也许正是为了使腹部无法动弹，黄翅飞蝗泥蜂才咬住猎物腹部末端的肉。	Hard 52 54 螫针
威尼斯城的法令等于一纸空文。	Complex 9 13 一纸空文
太阳并不在这个大车轮的中心，跟中心的距离约为二万七千光年。	Hard 26 28 光年
他的身量与筋肉都发展到年岁前边去；二十来的岁，他已经很大很高，虽然肢体还没被年月铸成一定的格局，可是已经象个成人了——一个脸上身上都带出天真淘气的样子的大人。	Complex 5 7 筋肉
这样，如果暴涨理论是正确的，宇宙就应包含足够的暗物质，使得密度达到临界值。	Hard 33 36 临界值
你只会感到更高邈、深远，并让凄冷的雨滴，去纯净你的灵魂，而且一定会遥望到一场秋雨后将出现的一个更净美、开阔的大地。	Complex 14 16 凄冷
后来，齐宣王死了，他的儿子齐湣王继承了王位。	Hard 13 16 齐湣王
大索城中；无，则之郭，之村，之山僻，之邻府州县。	Hard 9 10 郭
它没有婆娑的姿态，没有屈曲盘旋的虬枝，也许你要说它不美。	Hard 3 5 婆娑
他接受了我的定货，但没有皮革给我看；我可以意识到他的眼睛在细看我脚上的次等皮革。	Complex 37 39 皮革
驾驶员从雷达的荧光屏上，能够看清楚前方有没有障碍物，所以飞机在夜里飞行也十分安全。	Complex 4 6 雷达
它歪着脑袋，嘴巴向上翘成45度角——我看不出恐惧和紧张，它的表情就像在示威。	Complex 35 37 示威
鲧在临死前叮嘱儿子禹“一定要把洪水治好”。	Hard 0 1 鲧
我跟着他走到他刚才躺过的地方，坐了下来，忽然发现脚前的泥土上划满了各种各样奇怪的画儿：一座歪歪斜斜的塔，一堆松松散散的书，一株弯弯扭扭的树。	Complex 45 49 歪歪斜斜
甚至有的乞丐也油嘴滑舌地编起快板：“老太太（那个）真行好，给个饽饽吃不了。	Hard 14 16 快板
我也不过吃了饭就过来，你到午错的时候来领银子，后儿就进去种花儿。	Hard 13 15 午错
寂然饭毕，各有丫鬟用小茶盘捧上茶来。	Hard 0 2 寂然
据说他当初行为不正，糟蹋钱。	Hard 10 12 糟蹋
这样，如果暴涨理论是正确的，宇宙就应包含足够的暗物质，使得密度达到临界值。	Hard 5 7 暴涨
观众团团围坐，所有的剧情靠“雄谢巴”的解说和艺人们的说唱来描述。	Hard 14 17 雄谢巴
你是个烂忠厚没用的人，所以这些话我不得不教导你，免得惹人笑话。"	Hard 3 6 烂忠厚
它只是树林中的一个小小的长方形土丘，上面开满鲜花——nullacrux，nullacorona——没有十字架，没有墓碑，没有墓志铭，连托尔斯泰这个名字也没有。	Complex 62 65 墓志铭
他的脸上呈现出悲剧，一张含蓄了许多愁苦和力量的脸；火一样蓬勃的头发，盖在他的头上，好像有生以来从未梳过；深邃的眼睛略带灰色，有一种凝重不可逼视的光；长而笨重的鼻子下一张紧闭的嘴，衬着略带方形的下颏，整个描绘出坚忍无比的生的意志。	Complex 28 30 蓬勃
忽然看见一只硕大的天鹅在苇塘上空盘旋啼鸣，而在附近的水塘边，另一只天鹅在呼应着。	Complex 16 20 盘旋啼鸣
因向几个同案商议，瞒着丈人，到城里乡试。	Hard 4 8 同案商议
（《礼记・学记》）“乐群”这两个字很能代表中华文化的特点。	Hard 10 12 乐群
它们那“布谷，布谷”的亲切啼叫，分明是催促人们快快出工呢！	Complex 25 27 出工
杀死牛虻，真是不堪设想的恐怖，他感人肺腑的勇气，曾像太阳的光芒一样在他们死气沉沉的生活中闪耀，而现在，他必须死，死于他们之手，这对他们来说，就是去熄灭天上的明灯。	Hard 2 4 牛虻
比如“涕”，原来指眼泪，《庄子》里说：“哭泣无涕，中心不戚”。	Hard 27 29 不戚
我的冰棍从来都是好好的，你们不定吃了什么东西才闹肚子的。	Complex 23 26 闹肚子
彭德怀与牵着战马的警卫员跟在后边，焦急地察看着倒在草地上的烈士遗体。	Complex 29 31 烈士
他立刻又感到手指炙痛、痛入肺腑。	Complex 8 10 炙痛
教师入情入理的讲课也在我心里雕镂下深刻的印象，培养了我课外阅读的兴趣。	Complex 2 6 入情入理
我将历年收留的落叶拿出来，和这新叶比较，叶的轮廓是一样的。	Complex 22 24 轮廓
我少气无力地说，声音空空荡荡，随即散失在冰原上。	Complex 15 17 随即
我们要记着，从前历史上易朝换代是一个统治者代替了另一个统治者，但一切主要的生产技术及文明的、艺术的创造，却总是从人民手中出来的；为生活便利和安心工作的城市工程也不是例外。	Complex 11 15 易朝换代
象这样的冬天，乡下人叫作旱冬，对于麦的收成或者好些，但是人口却要受到损伤；旱得久了，白喉，流行性感冒等疾病自然容易上身，可是想恣意享受江南的冬景的人，在这一种冬天，倒只会得到快活一点，因为晴和的日子多了，去郊外去闲步逍遥的机会自然也多。	Hard 42 44 白喉
记得第一天上课，他给我们讲授的是一种名叫“猫猬兽”的动物。	Complex 21 24 猫猬兽
中华鲟也是一种古生物，它有一亿多年的历史。	Hard 0 3 中华鲟
我眼前又浮现出引人入胜的课堂，热火朝天的劳动，又去开心的郊游，你追我赶的赛场……	Complex 31 35 你追我赶
神奇的克隆技术正向人类展示它诱人的前景。	Complex 3 5 克隆
她梦想那些宽敞的客厅，那里张挂着古式的壁衣，陈设着精巧的木器，珍奇的古玩。	Hard 19 21 壁衣
看着这个比我还小两岁的小鬼头那么能干，我怕别人笑话话自己，只好跳下树，跟着柚根子走了。	Hard 37 40 柚根子
鲁达看时，只见郑屠挺在地下，口里只有出的气，没了入的气，动弹不得。	Hard 7 10 郑屠挺
李白时代的诗人，既挚恋着四川的风土文物，又向往着下江的开阔文明，长江于是就成了他们生命的便道，不必下太大的决心就解缆问桨。	Complex 44 46 便道
哥伦布噙着眼泪点了点头……	Hard 3 4 噙
一九四五年，我们战胜了日本强盗，我从延安回来，在碛口地方，跳到黄河里去洗了一个澡，一时大意，奔腾的黄水，冲走了我的全部衣物，也冲走了那双袜子。	Hard 24 26 碛口
记得童年与家人在庭院纳凉，母亲总要背诵唐人“银烛秋光冷画屏，轻罗小扇扑流萤”的诗句，其情境真够令人销魂的了。	Hard 22 29 银烛秋光冷画屏
线绕在锭子上，线穗子一层一层加大，直到大得沉甸甸的，像成熟了的肥桃。	Complex 7 10 线穗子
同年6月1日，孙中山先生的灵柩由北京香山碧云寺运来安葬，但末期工程直到1931年10月才全部竣工。	Complex 46 48 竣工
骈偶的来源很古。	Hard 0 2 骈偶
这短暂的一分钟，搅乱了台儿沟以往的宁静。	Complex 17 19 宁静
我有一时，曾经屡次忆起儿时在故乡所吃的蔬果：菱角、罗汉豆、茭白、香瓜。	Hard 29 31 茭白
予今长斯校，请以三事为诸君告：	Hard 0 5 予今长斯校
它们甚至改变了哪些永远痛苦的泥岩土丘，使其变了副模样。	Complex 14 18 泥岩土丘
这两种方法，似乎都是对牛弹琴。	Complex 10 14 对牛弹琴
宛如巨龙的橘红色火焰划破秋日的戈壁长空，托举着“神舟”5号飞船的火箭，在地动山摇般的轰鸣声中腾空而起，直指苍穹。	Complex 46 50 腾空而起
据统计，这里已发现的木本植物就有93科，517种，有活化石之称的珙桐、银杏、水杉比比皆是。	Complex 40 44 比比皆是
人们，在这山水中返璞归真了。	Hard 8 12 返璞归真
酒家看了道:“有余，还有些贴钱与你。”	Hard 13 15 贴钱
他决定要“格”院子里的竹子。	Hard 5 6 格
“是啊，莺儿，你要好好保存！	Complex 11 13 保存
这个理由似乎有理，但仍然是将克隆人当作工具或手段，如果克隆人不愿意作星际航行，而要回到地球去，怎么办呢？	Complex 34 38 星际航行
滚滚的春潮把坚冰击溃了，淹没了，迫使它驯服地和残冬一起向远方流去。	Complex 8 10 击溃
我应当向你说，把我的颈项伸长了，我就可以隔着窗看见对面的屋顶。	Complex 10 12 颈项
杨志提了朴刀，拿着藤条，自去赶那担子。	Complex 16 18 担子
苍茫暮色里，有几点星火在那边闪动，这是城中电灯放光了，我们不得不匆匆回去。	Complex 9 11 星火
自然，若是纱红上的字是“尚书府”或“某某县正堂”之类，懂得了意思，也会觉得不凡的；但普普通通一家纯德堂的家用灯笼，可也未始勾不起爱好来。	Complex 48 51 纯德堂
普罗米修斯这个人类伟大的朋友，这个曾经把火带给人类，使人类脱离了苦海、教会了人类怎么生活的伟大英雄，如今却身缠铁链被栓在山崖上。	Complex 0 5 普罗米修斯
许多同学都跟着一起背起来：“人有悲欢离合，月有阴晴圆缺，此事古难全。”	Hard 23 27 阴晴圆缺
但是，如果只凭冲劲，天不怕地不怕，就随便往羊皮筏上一蹲，那也会出大乱子。	Hard 7 9 冲劲
齐鲁青未了”，这“青未了”三个字，不正是生生不息的春色天边无际地流淌么？	Hard 0 5 齐鲁青未了
他整天呆在邯郭的大街上，看人家走路，边看边琢磨人家走路的特点，还跟在后边模仿。	Hard 5 7 邯郭
“青海长云暗雪山，孤城遥望玉门关。	Hard 9 16 孤城遥望玉门关
他长到最茂盛的中年，他伸展出他如盖的浓阴，来荫庇树下的幽花芳草，他结出累累的果实，来呈现大地无尽的甜美与芳馨。	Complex 52 54 芳馨
武松提了哨棒，大踏步走上景阳冈来。	Complex 4 6 哨棒
这只小朱鹮健康地成长着,后来,被送到北京动物园展出。	Hard 3 5 朱鹮
她们开始挎上装满核桃、鸡蛋、大枣的长方形柳条篮子，站在车窗下，抓紧时间跟旅客和和气气地做买卖。	Complex 38 42 和和气气
雨季则有青头菌、牛肝菌，味极鲜腴。	Hard 14 16 鲜腴
读到“青枫江上秋帆远，白帝城边古木疏”，就是一幅清淡的水墨画了，秋风送远了帆影——跟好朋友分别，心里是多么难舍啊！	Complex 3 5 青枫
通上电，我明白生命已操在他手，无论他如何“处理”我的头，我都不能有异议了。	Complex 33 35 异议
从玉龙雪山脚下，一直向南，铺展开去。	Complex 13 15 铺展
倘一看见两三岁的小孩子，她就说：	Complex 0 1 倘
我们感谢它，若是没有它，我们就不能在这里居住，那山村也不会曾经在这里滋长。	Complex 34 36 滋长
托尔斯泰面部的其他部件胡子、眉毛、头发，都不过是用以包装、保护这对闪光的珠宝的甲壳而已，这对珠宝有魔力，有磁性，可以把人世间的物质吸进去，然后向我们这个时代放射出精确无误的频波。	Hard 86 88 频波
二诸葛原来叫刘修德，当年做过生意，抬脚动手都要论一论阴阳八卦、看一看黄道黑道。	Complex 26 30 阴阳八卦
不过由于主题图案既反应社会风俗习惯，终不外生儿育女、夫妇和好，粮食丰收等幸福愿望，部分又必然和通俗流行戏剧小说结合，如祝梁友谊、桃园结义、许仙恋爱，或和节令相关，如龙舟竞渡、百子闹元背。	Complex 21 25 生儿育女
真要勉用文字来着色，也不过像谢灵运的一些名句“云日相晕映，空水共澄鲜”或是“出谷日尚早，入舟阳已微。	Hard 29 34 空水共澄鲜
休易的声音尖得像单簧口琴，“没这种事，医生。”	Hard 8 10 单簧
人们的诵经声和讨价还价的嘈杂声混在一起，香炉中吐出的桑烟香味与外国香水的气味混在一起，古老质朴的藏戏唱腔与节奏激烈的迪斯科乐曲混在一起……。	Complex 26 28 桑烟
一只胖胖的手在我的手掌里，像一条倔强的活鱼——样挣扎着。	Complex 16 18 倔强
有一次，一个叫做小福子的包身工整好了的烂纱没有装起，就遭了拿莫温的殴打，恰恰运气坏，一个“东洋婆”走过来了，拿莫温为着要在主子面前显出他的威风，和对东洋婆表示他管督的严厉，打得比平常格外着力。	Complex 29 32 拿莫温
爱能包容大千世界，使千差万别、迥异不同的人和谐地融为一个整体；爱能融化隔膜的坚冰、抹去尊卑的界线，使人们变得亲密无间；爱能化解矛盾芥蒂，消除猜疑、嫉妒和憎恨，使人间变得更加美好。	Complex 35 37 隔膜
车窗外是茫茫的大戈壁，没有山，没有水，也没有人烟。	Hard 8 10 戈壁
高尔基的儿子只有10岁，还没有镢头那么高。	Hard 15 17 镢头
五官溃烂，大小便不畅通，三更半夜在陕北甘泉县招待所转圈圈行走，以致招待所白所长犯了疑心，给县委打电话，说这个青年人可能神经错乱，怕要寻“无常”。	Complex 12 16 三更半夜
有一处需经隧道，穿山而过；俯瞰脚下峡谷，只见一股清流急湍其间，环顾四周，岩壁巉峻，丘岗葱绿，美不胜收。	Hard 36 40 岩壁巉峻
那王小玉唱到极高的三四叠后，陡然一落，又极力骋其千回百折的精神，如一条飞蛇在黄山三十六峰半中腰里盘旋穿插，顷刻之间，周匝数遍。	Hard 58 61 周匝数
均曰：“少坐献茶。”	Hard 4 8 少坐献茶
他下车伊始就拿出一部具有决定意义的作品，使自己跻身于大师的行列。	Hard 23 25 跻身
在举行仪式的前一晚，麦隆内夫人把赠与文件给她审阅，她很小心地读完，然后从容地说：	Complex 22 24 审阅
因这年秋尽冬初，天气冷将上来，家中冬事未办，狗儿未免心中烦躁，吃了几杯闷酒，在家里闲寻气恼，刘氏不敢顶撞。	Hard 35 37 闷酒
这里包含的诗人的感情，是对寒冷环境的反抗，也是对不屈的、斗争的品格的歌颂，有荷戟独彷徨的孤寂之感，也有永不停息战斗的低强精神。	Hard 38 43 荷戟独彷徨
只要孩子一失足，他就会跌到甲板上，摔个粉碎。	Complex 5 7 失足
我们见面和素常采访一样，礼节性地先握手。	Complex 5 7 素常
那棵树有一种端庄的王者风度，两人合抱粗的树干呈深黑色，树枝如巨大的龙爪，遒劲而伸展，缀满了繁密的树叶，即使在深冬也依然葱郁。	Hard 36 38 遒劲
他当年放弃在美国的优厚条件，坚决要求回到各方面都还十分落后的祖国，就是为了和祖国人民同呼吸、共患难，用他的知识和智慧建设国家，使祖国强大，人民幸福。	Complex 9 11 优厚
例如《诗经·鲁颂》的《駉》这一首诗里提到马的名称就有16种：“驈”(身子黑而胯下白的)，“皇”(黄白相间的)，“骊”(纯黑色的)，“黄”(黄而杂红的)，“骓”(青白杂的)，“駓”(黄白杂的)，“騂”(红黄色的)，“骐”(青黑成纹像棋道的)，“驒”(青黑色而有斑像鱼鳞的)，“骆”(白马黑鬃)，“駵”(红马黑鬃)，“雒”(黑马白鬃)，“駰”(灰色有杂毛的)，“騢”(红白杂毛的)，“驔”(小腿长白毛的)，“鱼”(两眼旁边毛色白的)。	Hard 147 148 駵
自高祖斩蛇起义，诛无道秦，是由乱而入治也；至哀、平之世二百年，太平日久，王莽篡逆，又由治而入乱；光武中兴，重整基业，复由乱而入治；至今二百年，民安已久，故干戈又复四起：此正由治入乱之时，未可猝定也。	Complex 3 7 斩蛇起义
忍不住东施效颦，到密林里览览胜，顺手牵羊，“乱砍乱伐”一下。	Complex 22 26 乱砍乱伐
他们在座舱里飘来飘去，仔细地检查一个个仪器，还不时地和地面指挥中心联络着……	Complex 3 5 座舱
然而，在爱因斯坦的想象中却出现了另一幅图景：这一千个太阳，没有给人世间带来温暖和光明，却在世界上投下了一千个阴影。	Complex 19 21 图景
行船的速度极快，来往船只很多，他操纵自如，毫不手忙脚乱。	Complex 23 27 手忙脚乱
任何降临在大地上的事，终究会降临在大地的孩子身上。	Complex 2 4 降临
“天行健，君子以自强不息；地势坤，君子以厚德载物。”	Hard 1 4 天行健
在此顺便说一句，我酷爱古典诗词，但能够从头背到底的，只有岳武穆的《满江红》“怒发冲冠”那一首，还有就是李易安的《声声慢》，她那几个叠字：“寻寻觅觅冷冷清清，凄凄惨惨戚戚……”	Hard 78 84 凄凄惨惨戚戚
戏唱得好，下边叫好捧场，像见到皇上，不少名角便打天津唱红唱紫、大红大紫；可要是稀松平常，要哪没哪，戏唱砸了，下边一准起哄喝倒彩，弄不好茶碗摇篮上去；茶叶末子沾满戏袍和胡须上。	Complex 9 11 捧场
艾尔肯是我们大队的一个机灵鬼——他的化险为夷、逢凶化吉的故事我将在另外的小说中讲，他的盛情是不能拒绝的，有时我甚至觉得我是需要他的保护的。	Complex 23 27 逢凶化吉
小地主的离开非常意外。	Complex 8 10 意外
随后，工作进入了设计期，他们要计算常人难以想象的庞大烦琐的数字，而当时用的只是手摇计算机。	Hard 39 41 手摇
曾子还说哩：“任重而道远”，“死而后已，不亦远乎！”	Hard 7 12 任重而道远
他的腿瘸得比往常更明显了，他重重地靠着军曹的胳膊，走得异常困难、痛苦，但他脸上所有的倦怠的温顺都无影无踪。	Complex 3 4 瘸
这时候，鄂温克姑娘们戴着尖尖的帽子，既大方，又销有点儿羞涩，来给客人们唱民歌。	Complex 27 29 羞涩
做着这等事，真是虽生之日，犹死之年，很可以驱除炎热的。	Complex 13 15 犹死
母亲对我说：“孩子，妈妈不是答应过你，等你爸爸寄回钱来，一定给你买支吸水笔吗？”	Complex 34 37 吸水笔
何满子被爷爷拴在葡萄架的立柱上，系的是拴贼扣儿。	Hard 0 3 何满子
另外，在一般学校学习的有30人，相对而言，一般城里孩子趋之若鹜的重点学校，却只有5名民工子女在其中就读。	Hard 27 31 趋之若鹜
那店小二把手帕包了头，正来郑屠家报说金老之事，却见鲁提辖坐在肉案门边，不敢拢来，只得远远地立住在房檐下望。	Complex 48 50 房檐
到了这个时候，诗的平仄逐渐有了定格。	Hard 9 11 平仄
比如说苏东坡的“惠山烹小龙团”诗里三四两句“独携天上小团月，来试人间第二泉”，“天上小团月”是由“小龙团”茶联想起来的，如果你不知道这个关联，原文就简直不通。	Hard 22 29 独携天上小团月
只是它的联想的意义迷离不易捉摸，它可以联想到燃烧弹，鸦片烟榻，庙里焚香，“一川烟水”，“杨柳万条烟”，“烟光凝而暮山紫”，“蓝田日暖玉生烟”……	Hard 37 41 一川烟水
傩送二老在茶峒地方不是一个生疏的名字！	Hard 0 2 傩送
大大小小几何形的麦田将原野均匀分割，种粒的全部能量转化为垄间破土而出的禾苗，它们将在秋天成熟，连绵不绝，设下朴素的宴席——握住镰柄的农民融入麦芒闪耀的金光里，积年劳作使他们的掌心磨砺出粗厚的老趼。	Hard 95 97 老趼
活人的塑像和大理石的塑像有一点不同，刀法如果用得不对，可以万像同毁，刀法如果用得对，则一笔下去，万龙点睛。	Complex 3 5 塑像
腮上没有多余的肉，脖子可是几乎与头一边儿粗；脸上永远红扑扑的，特别亮的是颧骨与右耳之间一块不小的疤——小时候在树下睡觉，被驴啃了一口。	Hard 36 38 颧骨
雨季则有青头菌、牛肝菌，味极鲜腴。	Complex 4 7 青头菌
过了几年，秦王约赵王在渑池会见。	Complex 11 13 渑池
燕雀、鸢和歌声婉转的鸫鸟,用清脆、纯净的声音唱着。	Hard 3 4 鸢
莲心里含有莲心碱、荷叶碱、木犀草甙、金丝桃甙等，有强心和降血压的功效。	Hard 13 17 木犀草甙
新华社香港7月1日凌晨电（新华社记者、人民日报记者）1997年7月1日零点，中华人民共和国国旗和香港特别行政区区旗在香港升起，经历了百年沧桑的香港回到祖国的怀抱，中国政府开始对香港恢复行使主权。	Complex 11 12 电
浅井之蛙听了这些话，瞠目结舌，觉得自己非常渺小。	Complex 0 4 浅井之蛙
她还会扎针、拔罐子、接生、接骨、看红伤。	Hard 16 19 看红伤
大家都把“中国石”奉为至宝，寂寞的时候，捧着它看看，心里感到温暖；劳累的时候，捧着它看看，就忘记了劳累。	Complex 5 8 中国石
狐偃说：“用兵打仗并不排除欺诈，您可以骗楚军上钓啊。”	Complex 22 24 上钓
“逃荒去，债也赖了，会钱也不用解了，好打算，我们一块儿去！”	Hard 10 12 会钱
得胜的吴王非常骄傲，不听大家的建议，答应了勾践的请求。	Complex 21 23 勾践
这样我就能够拍下好几百张由反物质留在云室中的精美照片。	Hard 13 16 反物质
将军既帝室之胄，信义著于四海，总揽英雄，思贤如渴，若跨有荆、益，保其岩阻，西和诸戎，南抚彝、越，外结孙权，内修政理；待天下有变，则命一上将将荆州之兵以向宛洛，将军身率益州之众以出秦川，百姓有不箪食壶浆以迎将军者乎？	Hard 44 45 彝
威尔莫特等学者先给苏格兰黑面羊注射促性腺素，促使它排卵。	Hard 17 21 促性腺素
他的脚腕被蹭破了，因为他没穿袜子。	Complex 5 6 蹭
我把它放在身边的窗栏上，让它苏醒过来，那时它的生命的火焰跳动还是很微弱，它依然静静地伏着；我于是把几朵盛开的鲜花放在它的触须前面，让它可以有一点东西吃；正在这时一只鸫鸟在窗前响亮而又神气地唱起歌来，唱得嘹亮极了；、我不禁大声说:你听，这只小鸟歌唱得多愉快，那么你这小小的生命也必须恢复过来才是！	Hard 82 84 鸫鸟
至于公和私的关系，人和己的关系，应以人为先，正如孔子所说：“君子贵人而残己，先人而后己。”	Hard 30 37 君子贵人而残己
她记起祖父嘱咐她不要离开原来地方那一句话，便又为自己解释这想头的错误，以为祖父不来必是进城去或到什么熟人处去，被人拉着喝酒，一时不能脱身。	Complex 5 7 嘱咐
鲁达看时，只见郑屠挺在地下，口里只有出的气，没了入的气，动弹不得。	Hard 10 13 在地下
年轻人之所以为年轻人，并不是单看年纪轻，假如是单看年纪轻，我们倒看见有好些年纪轻轻的人，却已经成了老腐败，老顽固，甚至活的木乃伊——虽然还活着，但早已死了，而且死了几千年。	Complex 53 56 老顽固
四叔家里这回须雇男短工，还是忙不过来，另叫柳妈做帮手，杀鸡，宰鹅；然而柳妈是善女人，吃素，不杀生的，只肯洗器皿。	Hard 53 55 器皿
）也恍惚记得她身上那片不太鲜丽的蓝。	Complex 2 4 恍惚
“我就是叫作藤野严九郎的……。”	Complex 6 11 藤野严九郎
至如梁、柱、枋、標、门、窗、墙、瓦、植、阶、栏杆、隔扇、斗拱、正脊、垂脊、正吻、戗兽、正房、厢房、游廊、庭院、夹道等等。	Hard 8 9 標
我和村里的伙伴们经常来到这块白水边，在几株垂柳下脱光了衣服，走过一段湿润的沙地，跳入清凉的水中。	Complex 21 23 垂柳
这种颜色，我就叫它“阜平蓝”或是“山地蓝”吧。	Hard 10 13 阜平蓝
孩子们愉快地、心满意足地坐在泉井旁的石板上，观赏着清澈的泉水。	Complex 7 11 心满意足
他是那么潇洒地将花束抛向了乐手们，台下响起了激动人心的掌声，于是，郎朗又一次深深弯下腰，行了一个绅士派头的大礼，然后，沉静地端坐在钢琴前——钢琴那乌亮的板壁在灯光下反射的光泽，在我看来都具有了强烈的离情色彩。	Hard 99 101 离情
分群的时刻来到，老蜂王打算带着它的一半家口离窠而去，这时的景象就像蜂窠在进行有丝分裂。	Hard 21 25 离窠而去
曹操听到鼓声和呐喊声，就下令说：“江上雾很大，敌人忽然来攻，我们看不清虚实，不要轻易出动。	Complex 35 37 虚实
舒活舒活筋骨，抖擞抖擞精神，各做各的一份事去，“一年之计在于春”；刚起头儿，有的是工夫，有的是希望。	Hard 24 31 一年之计在于春
据说当时曾用狼粪来作燧，因为狼粪的烟可以直上云霄，远处容易看见，所以又称烽火台为狼烟台。	Hard 9 11 作燧
可是一查黄河近2000年来的表现，却叫人大吃一惊。	Complex 20 24 大吃一惊
不过，简短的诗可以有悠远的意味，收缩并不妨碍延长，仿佛我们要看得远些，每把眉眼颦蹙。	Hard 39 41 颦蹙
休息够了，一队黑狗子先走，想从小路走上峁去。	Hard 19 20 峁
笑了一阵，他忽然若有所思地说：“不过，人类也许应该从旅鼠身上学到点什么。	Hard 26 28 旅鼠
江理以“从者七人，二僧与俱”，组成一支浩浩荡荡的登山队，“一仆前持斧斤，剪伐丛莽，一仆鸣金继之，二三人肩糗执剑戟以随。”	Hard 29 35 一仆前持斧斤
人类基因组计划所发展起来的战略与技术使生物资源由原先的群体种质（野生与优质品种的种质）资源转变为序列化与信息性，技术带来的资源信息性又使它的保护更为困难。	Hard 29 31 种质
他用粉笔在黑板上一笔一画地写着：	Complex 8 12 一笔一画
今诸君苟不于此时植其基，勤其学，则将来万一因生计所迫，出而仕事，但任讲席，则必贻误学生；置身政界，则必贻误国家。	Hard 3 6 苟不于
在宇宙的大生命中，我们是多么卑微，多么渺小，而一滴一叶的活动生长合成了整个宇宙的进化运行。	Complex 19 21 渺小
沿着岩壁折缝，一个个地走将出来，薄纱轻绸，露出的身段翩然起舞。	Complex 26 30 翩然起舞
时云长在侧曰：“某闻管仲、乐毅乃春秋、战国名人，功盖寰宇；孔明自比此二人，毋乃太过？”	Hard 13 18 乐毅乃春秋
南亚的印度河——恒河流域，也是人类四大文明古国之一的印度的发源地。	Complex 10 12 流域
我的朋友们，“他说，“我的期友们，我，我，……	Hard 13 15 期友
无智慧的书，往往材料堆积得和蚁丘一样，议论虽多，见解毫无。	Complex 24 26 见解
他向负责科学研究的威尔逊要了十片吗啡，以便在必要时加快结束自己。	Hard 16 18 吗啡
也许是这里的奇峰交给他一副傲骨，这位比李白还老的疯诗人太不安分，长剑佩腰，满脑奇想，纵横中原，问天索地，最终投身汨罗江，一时把那里的江水，也搅起了三峡的波涛。	Complex 42 46 纵横中原
极目处，四野八荒，惟有黄色，尽是黄色。	Hard 0 2 极目
至于视觉经验，也都表现得很有动感：写荷花迎风则“红披绿偃，摇荡葳蕤”，写微风拂水则“细生鳞甲”，写流萤则“（幽火）班班，若骇若惊，奄忽去来”，写山则“森森欲下搏人”。	Hard 75 81 森森欲下搏人
到得岭下，早有七八十人都哄将来，先把死大虫抬在前面，将一乘兜轿，抬了武松，径投本处一个上户家来。	Hard 29 31 兜轿
他们衣着鲜艳，步态轻盈。	Complex 7 11 步态轻盈
（《礼记・坊记》）范仲淹所说“先天下之忧而忧，后天下之乐而乐”＂（《岳阳楼记》）也体现了这种精神。	Hard 23 30 后天下之乐而乐
转眼间,整个王国天昏地暗。	Complex 8 12 天昏地暗
不言而喻，在创造的宇宙里，贝多芬、爱因斯坦、莎士比亚是光辉灿烂的明星。	Complex 0 4 不言而喻
去的尽管去了，来的尽管来着；去来的中间，又怎样地匆匆呢？	Complex 24 26 匆匆
我们那里上学的岁数是多拣单数的，所以这使我记住我其时是七岁。	Hard 11 12 拣
于是分头四出，寻黑矮汉，寻梢长大汉，寻头陀，寻胖大和尚，寻茁壮妇人，寻姣长妇人，寻青面，寻歪头，寻赤须，寻美髯，寻黑大汉，寻赤脸长须。	Complex 35 37 姣长
“人文”这个词起源很早，《周易・责卦・彖辞》说：“观乎天文，以察时变；观乎人文，以化成天下。”	Hard 30 34 以察时变
在这儿，我已经笨拙地给你们介绍了住公寓套间的两个傻孩子不足为奇的平淡故事，他们极不明智地为了对方而牺牲了他们家最最宝贵的东西。	Complex 7 9 笨拙
虽然，弟子们也试着摘了几穗，但并不满意，便随手扔掉了。	Complex 12 13 穗
我用鞭子着实教训了它一顿。	Hard 4 6 着实
肚子里先有了这三个人作了底子，然后再把陶渊明、应玚，谢、阮、庾、鲍等人的一看。	Hard 30 31 庾
袁世凯称帝，最终失败，和陈宧关键时刻的倒戈有绝对关系。	Hard 12 14 陈宧
香菱笑道：“我只爱陆放翁的诗‘重帘不卷留香久，古砚微凹聚墨多’，说的真有趣！”	Hard 15 22 重帘不卷留香久
因为我们的许多白人兄弟已经认识到，他们的命运与我们的命运是紧密相连的，他们今天参加游行集会就是明证。	Complex 29 33 紧密相连
亲爱的家乡孩子们，我真羡慕你们。	Complex 11 13 羡慕
歌乐山下悟道	Hard 4 6 悟道
龙门是黄河上的一个古老的渡口，是陝西、山西两省的交通要道。	Hard 12 14 渡口
如果一个人用尽全身之力，把嗓门憋得尖尖的，发出“哦——啊”的叫声，虽说比不上大鹦鹉的气势，听起来也蛮像了。	Complex 49 50 蛮
补课完毕，她才看到窗外正飘洒着细细的雨丝。	Complex 12 14 飘洒
“妈妈”“妈妈”的喊声，震响在周围。	Complex 12 14 震响
要学有所成，就要“自迩”“自卑”开始，就要刻苦磨炼，持久积累。	Hard 9 11 自迩
如果秦王真的拿十五座城来换，我就把璧交给他；如果他不肯交出十五座城，我一定把璧送回来。	Complex 17 18 璧
那天傍晚，当轮船航行在相模滩的海面上的时候，那男人和他的妻子一起，带着他们的长子来到那位妇人的舱房。	Complex 47 49 舱房
有了秦腔，生活便有了乐趣，高兴了，唱“快板”，高兴得像被烈性炸药爆炸了一样，要把整个身心粉碎在天空！	Complex 19 21 快板
他并没有听到喘息声，他只是从梦里慢慢苏醒过来，觉得有条舌头在顺着他的一只手舔去。	Complex 37 38 舔
太阳光经过三棱镜或水滴的折射，会分成红、橙、黄、绿、蓝、靛、紫七种颜色。	Hard 28 29 靛
一个人呷了一口酒，幽幽地提出疑问。	Hard 3 4 呷
如果孕妇怀孕期间睾丸素水平较高，生下的孩子就更容易成为左撇子，也更容易在日后得心脏疾病和孤僻症。	Hard 8 11 睾丸素
战斗开始后的几十分钟里，一切顺利，伤员一次次带下来的消息，都是我们突破第一道鹿砦，第二道铁丝网，占领敌人前沿工事打进街了。	Hard 38 40 鹿砦
刘邓大军各部偃旗息鼓，星夜南下，一步步穿越大片淤泥埋没了屋顶的死亡地带——黄泛区。	Complex 23 25 淤泥
明屠本畯有一首诗，叙述煎荔枝的方法，说“旋沉荔花蜂酿蜜，清香不减蔗浆寒”，大概是关于荔枝蜜最早的记载。	Hard 0 4 明屠本畯
《东京梦华录》中所记述的街巷、酒楼、饮食果子，以及“天晓诸人入市”“诸色杂卖”等，都能在这画面中找到生动的图释。	Hard 34 36 诸色
少焉，月出寒阴，微明散布石上，松声倏然自万壑来，客皆悚视寂，觉境愈清，思愈远。	Hard 15 23 松声倏然自万壑来
蔡林把信纸放回信封里，小心折叠起来，放进口袋，大踏步回家去。	Complex 13 15 折叠
蝉刚把卵装满一个小孔，到稍高的地方另做新孔，蚋立刻来到这里。	Hard 22 23 蚋
银杏树，又叫白果树，它是几亿年前的树种，十分珍贵。	Complex 17 19 树种
万卡不是个娇滴滴的小姑娘，他那时才九岁，一个人孤零零地在城里当学徒，吃不饱，还要挨打，他伤心极了，盼望爷爷去救他，他是在恳求，在哭诉，绝不该有这种撒娇的腔调。	Complex 5 8 娇滴滴
人们纷纷指着毡靴，对爷爷说：	Complex 6 8 毡靴
我很兴奋，即刻就想去看看，却又矜持，不愿在同学面前显出我的迫不及待。	Complex 15 17 矜持
为了避雨，祖孙二人同那只黄狗，走到顺顺吊脚楼上去，挤在一个角隅里。	Hard 19 22 吊脚楼
此外，他还是个暴躁的小老头儿，极端瞧不起别人的温情，却认为自己是保护楼上两个青年艺术家的看家恶狗。	Complex 15 17 极端
有一天，一个英国士兵在清理战场时，突然挖出了一个丹麦人的头骨，他想到自己的祖国被侵战和破坏的情景，禁不住怒火万丈。	Complex 52 56 怒火万丈
“止水结冰是何情状？	Hard 7 9 情状
否则，鸠占鹊巢，李代桃僵，那屋内必是鸡飞狗跳，不得安宁。	Hard 8 12 李代桃僵
这些作品广为流传。	Complex 4 8 广为流传
我没有亲见；听说她，刘和珍君，那时是欣然前往的。	Complex 18 22 欣然前往
手术完成之后，用相同频率的电脉冲刺激换核卵，让苏格兰黑面羊的卵细胞质与芬多席特母羊乳腺细胞的核相互协调，使这个“组装”细胞在试管里经历受精卵那样的分裂、发育而形成胚胎的过程。	Hard 33 34 质
被子植物的花有了花被，更分化为花萼和花冠（花被和花冠通称花瓣）。	Hard 8 10 花被
可是，她拗不过老头子，也怕伤了儿子的心，不乐意也只得同意了。	Hard 4 5 拗
惟有朱子解的最好，他说：“主一无适便是敬。”	Hard 13 20 主一无适便是敬
福楼拜转动着蓝色的大眼睛盯着朋友这张白晳的脸，十分钦佩地听着。	Complex 25 27 钦佩
沙子还有一种医疗作用。	Complex 6 8 医疗
伏尔泰直接面对这种轻薄无聊而又凄惨忧郁的社会，独自一人，眼前是各种力量的联合，宫廷、贵族、金融界；这支不自觉的力量，是盲目的一大群人；这批无恶不作的法官，他们媚上欺下，俯伏于国王之前，凌驾于人民之上（喝彩）；这批虚伪、狂热、阴险兼而有之的神职人员，伏尔泰，我再说一遍，独自一人对这个社会一切丑恶力量的大联合，对这个茫茫的恐怖世界宣战，他接受战斗。	Complex 79 83 媚上欺下
可是，在自然看来，人类上下翻飞的这片巨大空间，不过是咫尺之间而已，就如同鲲鹏看待斥鴳一般，只是蓬蒿之间罢了。	Hard 36 38 鲲鹏
《千家诗》中很大一部分诗歌歌咏祖国风物，按春夏秋冬时序编排，打开书往下念，四季风光就活生生地展现在眼前：“成紫千红总是春”，“春城无处不飞花”；“绿树阴浓夏日长”，“五月榴花照眼明”；“青女素娥俱耐冷，月中霜里斗婵娟”；“梅雪争春未肯降，骚人搁笔费评章”……	Hard 101 108 月中霜里斗婵娟
妈妈抚摸着尤拉的头，说：“你可以带妹妹去玩，给小狗喝水，帮奶奶刷碗。”	Complex 5 7 尤拉
往日同游的朋友，虽然已经云散，然而鱼翅是不可不吃的，即使只有我一个……	Hard 12 14 云散
至于雨敲在鳞鳞千瓣的瓦上，由远而近，轻轻重重轻轻，夹着一股股的细流沿瓦槽与屋檐潺潺泻下，各种敲击音与滑音密织成网，谁的千指百指在按摩耳轮。	Hard 66 68 耳轮
这样一来，还不到天黑，全瓦尔杰茨基公国的人便无人不知弗里德里螦撒国王是“世界上最傻的傻瓜，傻瓜中的傻瓜”了，而警察局长第二天也就下台大吉。	Complex 22 26 无人不知
而且往往是白天休整进食，晚上摸黑前进。	Complex 14 16 摸黑
我大大地领略了一番这温暖而挨打的欢欣。	Complex 4 6 领略
我们已经把这个店铺过户过来了。	Complex 9 11 过户
刷完牙后，我会将多余的牙膏与水吐在曾用来洗澡的同一块布上，然后除去头发上的香波。	Hard 37 39 香波
卢诺尔曼兴奋地大叫起来，周围的人们一齐为他喝彩。	Complex 21 23 喝彩
没有充分的理由来为克隆人的行为在伦理学上进行辩护。	Complex 16 19 伦理学
有弗学，学之弗能弗措也；有弗问，问之弗知弗措也；有弗思，思之弗得弗措也；有弗辨，辨之弗明弗措也；有弗行，行之弗笃弗措也。	Hard 12 15 有弗问
这条发展的途径，中国建筑和欧洲希腊、罗马的古典建筑体系，乃至埃及和两河流域④的建筑体系是完全一样的，所不同者，是那些体系很早就含弃了木材而完全代以砖石为主要材料。	Complex 63 65 含弃
所有这一切难道不比眼前这种浮华的喧嚣更让人向往吗？	Complex 13 15 浮华
江南的地质丰腴而润泽，所以含得住热气，养得住植物；因而长江一带，芦花可以到冬至而不败，红叶亦有时候会保持三个月以上的生命。	Complex 5 7 丰腴
就要收庄稼了，收庄稼前，要把道路修一修，补一补，这是村里的风俗。	Hard 29 31 风俗
他攀上去后，其他几个年轻人也一上去，终于将塔刹的各部尺寸、做法测绘下来。	Complex 31 33 测绘
等到大批人群过去，又有一些人姗姗来迟，他们只要有兴趣在饥饿艺术家跟前停留，是不会再有人妨碍他们的了，但这些人为了能及时看到兽畜，迈着大步，匆匆而过，几乎连瞥也不瞥他一眼。	Complex 43 45 妨碍
）老人一声不响，却笑呵呵地伸手在烘缸里取出一个小小的烤山薯，往我手里一放说：“给你吃。”	Hard 16 18 烘缸
两人吃完饭坐在屋里，因屋前滨水，长脚蚊子一到黄昏就嗡嗡地叫着，翠翠便把蒿艾束成的烟包点燃，向屋中角隅各处晃着驱逐蚊子。	Hard 48 50 角隅
于是六国之士，有宁越、徐尚、苏秦、杜赫之属为之谋，齐明、周最、陈轸、召滑、楼缓、翟景、苏厉、乐毅之徒通其意，吴起、孙膑、带佗、倪良、王廖、田忌、廉颇、赵奢之伦制其兵。	Hard 37 39 楼缓
夸父又向北方跑去，想去喝大泽里的水。	Hard 12 14 大泽
莫高窟里还有一个面积不大的洞窟——藏经洞。	Complex 17 20 藏经洞
《红楼梦》是我在十二三岁时候看的，起初我对它的兴趣并不大，贾宝玉的女声女气，林黛玉的哭哭啼啼，都使我厌烦，还是到了中年以后再拿起这部书看时，才尝到“满纸荒唐言，一把辛酸泪”一个朝代和家庭的兴亡盛衰的滋味。	Hard 80 85 一把辛酸泪
自然，从古至今，大概是没有人在上面滑过雪展的。	Complex 3 7 从古至今
我们往往还会看到触须的颤抖和触角以及腹肌十分明显的运动：彼此盆开，然后突然并拢。	Hard 30 32 盆开
看见波涛涌来，双脚蹬着海底一跳，身体就被浪涛举到半空，接着又顺水波落下，其乐无穷。	Complex 36 40 其乐无穷
杨志道：“深谢恩相抬举。”	Hard 7 9 恩相
只见黛玉正拿着诗和他讲究。	Hard 10 12 讲究
今诸君苟不于此时植其基，勤其学，则将来万一因生计所迫，出而仕事，但任讲席，则必贻误学生；置身政界，则必贻误国家。	Hard 44 48 置身政界
那个人接过来翻来覆去地仔细看了一阵儿，又掂了掂分量，拿起一个放大镜，把他的伙计叫过来，小声嘀咕了几句，然后把项链放在柜台上，瞧瞧远看的效果如何。	Complex 45 47 嘀咕
他不怕任何艰难困苦，他富于弹性，倒下去立刻跳起来，碰伤了舐干血迹，若无其事，他以牺牲自我的意志征服一切。	Hard 28 29 舐
这么多的狮子，姿态不一，没有哪两只是相同的。	Complex 7 11 姿态不一
心中想着，忽见丫鬟话未报完，已进来了一位年轻的公子：头上戴着束发嵌宝紫金冠，齐眉勒着二龙抢珠金抹额；穿一件二色金百蝶穿花大红箭袖，束着五彩丝攒花结长穗宫绦，外罩石青起花八团倭缎排穗褂；登着青缎粉底小朝靴。	Hard 75 77 宫绦
妈妈说的羚羊是一只用黑色硬木雕成的工艺品。	Complex 13 15 木雕
解放以来，我们的地质部、石油部、中国科学院的工作人员已经好几次横穿新疆塔克拉玛干大戈壁，并没有什么鬼怪离奇的东西阻挡了他们的行进，这是什么缘故呢？	Complex 49 53 鬼怪离奇
有一些科学家不同意“演习说”。	Hard 10 12 演习
桌子也是后来才有的，古代只有“几”“案”，都是很矮的，适应席地而坐的习惯，后来坐高了，几案也不得不加高，于是有了新的名称，最初就叫“卓子”(“卓”是高而直立的意思)，后来才把“卓”写做“桌”。	Complex 18 19 案
李逵也不答应他，便就地下掳了银子，又抢了别人赌的十来两银子，都搂在布衫兜里，睁起双眼说道：“老爷闲常赌直，今日权且不直一遍。”	Hard 50 52 赌直
邢夫人苦留吃过晚饭去，黛玉笑回道：“舅母爱惜赐饭，原不应辞，只是还要过去拜见二舅舅，恐领了赐去不恭，异日再领，未为不可。	Hard 55 59 未为不可
巢窠散落在地面上，小耗子又会发现它们，将毡靴的残毛搬进自己地下的窝中。	Hard 0 2 巢窠
不久，一道道的美味就上来了，有葛根粥、蕨叶炒山姜（月桃的块茎）、野菜炒虾仁、山刺瓜姜荡、烤鱼、烤虾，上面撒了山胡椒粉，还有在火堆里焖熟的天门冬块根，真是丰盛极了。	Complex 19 21 蕨叶
我们的服装包括一件棉T恤，一条棉短裤和一双汗袜。	Complex 21 23 汗袜
先生家里有人把锁匙从门缝里递出来，我拿了跑回去，开了门，坐下念生书。	Complex 10 12 门缝
吃饭时，凤姐与鸳鸯商议要拿刘姥姥取个笑儿。	Hard 18 20 笑儿
2008名乐手击缶吟诵，那吟声细细听来，分明是:“有朋自远方来，不亦乐乎？”	Hard 7 11 击缶吟诵
狂风吹来了，洪水冲来了，冰河爬来了，碎石、沙砾、泥土被它们带着，开始了旅行。	Complex 21 23 沙砾
许先生说鸡鸣的时候，鲁迅先生还是坐着，街上的汽车嘟嘟的叫起来了，	Complex 24 26 嘟嘟
有时直立起来，状似舞蹈；有时背倚石头，坐在草地上悠然自得地啃着竹枝；有时团作一团，漫不经心地随地打滚；有时拖着笨拙的身体，摇摇晃晃地在草地上玩耍。	Complex 24 28 悠然自得
在林间草地上我意外地发现了一颗晚熟的硕大草莓。	Complex 15 17 晚熟
至于公和私的关系，人和己的关系，应以人为先，正如孔子所说：“君子贵人而残己，先人而后己。”	Hard 38 43 先人而后己
三座大殿矗立在七米多高的白石台基上。	Hard 4 6 矗立
打倒那劣绅和土豪！	Complex 6 8 土豪
我一起锅就吃，比你们还先吃呢。	Complex 1 4 一起锅
有几个女人拗不过孩子的欲望，便给他们买了最便宜的小洋囝囝。	Hard 26 28 囝囝
况且这通身的气派，竟不像老祖宗的外孙女儿，竟是个嫡亲的孙女。	Complex 3 5 通身
四百多年里，它剥蚀了古殿檐头浮夸的琉璃，淡褪了门壁上炫耀的朱红，坍圮了一段段高墙又散落了玉砌雕栏，祭坛四周的老柏树愈见苍幽，到处的野草荒藤也都茂盛得自在坦荡。	Complex 12 14 檐头
站在罗布泊边缘，你能看清那一道道肋骨的排列走向，看到沧海桑田的痕迹，你会感到这胸膛里面深藏的痛苦与无奈。	Complex 16 18 肋骨
大熊猫是我国国宝，已列为国家一级保护动物，也是世界珍稀动物中的重点保护对象。	Complex 25 29 珍稀动物
徽曰：“孔明与博陵崔州平、颍川石广元、汝南孟公威与徐元直四人为密友。	Hard 0 1 徽
细末里头不免掺和着铁臼上磨下来的铁屑，他们利用吸铁石除掉它。	Hard 9 11 铁臼
当时已经用灌气的球代替了用鬃毛填充的球，而且有了球门和规则的球场，设备器材方面也逐渐完善。	Hard 13 15 鬃毛
阿拉伯人是对沙漠广有经验的民族，阿拉伯语中称这一现象为“魔鬼的海”。	Hard 28 30 魔鬼
“神女”一词终于由瑰丽走向淫邪，无论哪一种都与健全的个体生命相去遥遥。	Complex 9 11 瑰丽
狂风大作的时候我在温暖的室内，却不会想到风是如何污辱我和我的树苗的——它把我的树从窗台上抱起来，砸在河边石埠上，然后又把树苗从花盆里拖出来，推向河水里，将一只破碎的花盆和一抔泥土留在岸上，留给我。	Complex 24 26 污辱
但门槛是母亲的位置。	Complex 1 3 门槛
李震说“河水很深，不能徒涉。”	Hard 11 13 徒涉
记得一次教辛弃疾的词《南乡子登京口北固享有怀》，老师朗诵时头与肩膀左右摇摆着，真是悲歌慷慨，我们这些做学生的，爱国情怀油然而生。	Complex 59 63 油然而生
这样布置后，它打开了它的云库，拨给这区域的，有倏来倏去的云，扑朔迷离的雾，绮丽多彩的霞光，雪浪滚滚的云海。	Hard 23 27 倏来倏去
徽曰：“孔明与博陵崔州平、颍川石广元、汝南孟公威与徐元直四人为密友。	Hard 19 22 汝南孟
转了两个弯儿，出现岔口，那年轻人说：“谢谢啦，您自便吧……”	Complex 9 11 岔口
经过三年又九个月，他们终于在成吨的矿渣中提炼出了0.	Complex 20 22 提炼
州平曰：“山野之夫，不足与论天下事，适承明问，故妄言之。”	Hard 18 22 适承明问
他开始跑起来，将外套、皮靴、水袋与帽子一件一件扔掉，只留下铁锨做拐杖。	Hard 29 31 铁锨
爱默生认为，每一个人都应当与这世界上的劳作保持着基本关系。	Complex 0 3 爱默生
否则，我们将无面目对子孙后辈讲述这一段光荣历史了。	Complex 10 14 子孙后辈
他家的二小姐着实爽快，会待人的，倒不拿大，如今现是荣国府贾二老爷的夫人，听见他们说，如今上了年纪，越发怜贫恤老的了，又爱斋僧布施。	Hard 18 20 拿大
彝家有一句谚语：过年是嘴巴的节日，火把节是眼睛的节日。	Hard 0 2 彝家
有一种人，读书虽然不多，但他对于人情事理，都很通达，凭借经验，运用心得，“官知止而神欲行，依乎天理，批大郤，导大窾”。	Hard 54 57 导大窾
他们将自己的手掌按在石头上，然后往上喷赭色或者黑色的粉末。	Hard 19 21 赭色
可我们楼前池塘中独独缺少荷花。	Complex 8 10 独独
自然是江南日暮的雪景；“寒沙梅影路，微雪酒香村”，则雪月梅的冬宵三友，会合在一道，在调戏酒姑娘了；“柴门闻犬吠，风雪夜归人”，是江南雪夜更深人静后的景况；“前村深雪里，昨夜一枝开”，又到了第二天的早晨，和狗一样喜欢弄雪的村童来报告村景了。	Hard 12 17 寒沙梅影路
我回到堂前，看见中堂挂着的立轴──吴昌硕描的墨竹，似觉更有意味。	Hard 13 15 立轴
“绿”字描绘出了江南春风的气韵，引出下句“明月何时照我还”。	Hard 27 28 还
月光照进窗子来，屋子里的一切好像披上了银纱，显得格外的清幽。	Complex 27 29 清幽
观其大略同样需要认真读书，只是不死抠一字一句，不因小失大，不为某一局部而放弃了整体。	Complex 0 4 观其大略
积成峁，堆成墚，又堆积成一大片一大片的塬。	Hard 19 20 塬
哈姆莱特那不过是一种傻气的心理；可是一个女人也许会因为这种莫名其妙的疑虑而惶惑。	Complex 0 4 哈姆莱特
他们都不以家乡为终点，就像三峡的水拼着全力流注四方。	Complex 21 25 流注四方
并且，我想就是来得大些，也不见得如人们所大吹的那么“奇观”，自己从前所幻想的那么奇目吧？	Hard 40 42 奇目
和乌鸦很相像的那种怪样子的墨鸭，整排地停在舷上，它们的脚是用绳子吊住了的，下水捕鱼，起水的时候船户就在它的颈子上轻轻地一挤！	Hard 21 22 舷
啪啪声里，一道道浆，衔接得天衣无缝，刷过去的墙面，真好比平平整整打开一面雪白的屏障。	Complex 13 17 天衣无缝
在中国最早的新闻学著作之一《实际应用新闻学》中，邵飘萍主张记者“其脑筋无时休息，其耳目随处警备，网罗世间一切事物而待其变。”	Hard 45 47 警备
你们试看那些繁殖在南美各地自由自在地生活着的马匹吧：它们行走着，它们奔驰着，它们腾跃着，既不受拘束，又没有节制；它们因不受羁勒而感觉自豪，它们避免和人打照面；它们不屑于受人照顾，它们能够自己寻找适当的食料；它们在无垠的草原上自由地游荡、蹦跳，采食着四季皆春的气候不断提供的新鲜产品；它们既无一定的住所，除了晴明的天空外又别无任何庇荫，因此它们呼吸着清新的空气，这种空气，比我们压缩它们应占的空间而禁闭它们的那些圆顶宫殿里的空气，要纯洁得多，所以那些野马远比大多数家马来得强壮、轻捷和遒劲。	Complex 241 243 遒劲
现在，湖底的树干，古老的独木舟，黑魆魆的四周的林木，都没有了，村民本来是连这个湖在什么地方都不知道的，如今却想到用一根管子来把这些湖水引到村中去洗碗洗碟子了。	Hard 16 19 黑魆魆
中国使者抱拳，作揖还礼：“有劳将军远迎。	Hard 7 11 作揖还礼
更兼单身客人，亦不敢独自经过。	Hard 0 2 更兼
紧接着，香烟又举到唇际，烟头闪耀，还是吸得那么深，那么狠，烟灰一个劲地延伸，然后折断，然后跌落……	Complex 9 11 唇际
穿在身上的100多磅重的铠甲，只能部分地分散我身上的负重。	Hard 9 10 磅
自然，也可以扩大精神，增加智识的，但这些倒都不计及，一计及，便等于意在赢钱的博徒了，这在博徒之中，也算是下品。	Hard 23 25 计及
袁世凯的亲信陈宧对章太炎的评价更高，因为章太炎最初见到陈宧时，便说过陈宧这人是第一等人物，然而日后灭亡民国者，必此人无疑。	Hard 6 8 陈宧
在一秒钟之内，我们就把枪弹上了膛，过度的兴奋竟使我们无法瞄准。	Complex 28 30 瞄准
响尾蛇每次蜕皮时最后一个鳞片都不能脱落而加在末端，鳞环记录着岁月的痕迹，也是它慢慢聚敛的财富。	Hard 25 27 鳞环
虽然远处大片大片的花与蒙蒙细雨融在一起，低头却能清晰地看到，在冷雨中，每一朵小花都傲然挺立，明亮夺目，神气十足。	Complex 46 50 明亮夺目
到了仲夏，呜蝉将在你的浓阴下长啸，等一场台风袭过，那啰哕蝉鸣变成了凄切的哀吟，天气也随之凉爽起来。	Hard 26 30 啰哕蝉鸣
再看这三个字形，第一个是两只手恭恭敬敬地捧着“册”；第二个字中，六形是个底座，其中上面是搁板，下面是支撑它的脚，册”被庄重地安放在底座上；第三个字形，是两只手捧着“册”将它陈放在底座上。	Complex 44 46 搁板
天每天升高一丈，地每天下沉一丈，盘古也随着越长越高。	Hard 5 7 一丈
而从这一天起，他就不断地有作品问世，他高产，稳产，显示出炉火纯青的功力，令我惊叹。	Complex 28 32 炉火纯青
于是，伯父家盖房，想以它垒山墙，但苦于它极不规则，没棱角儿，也没平面儿；用錾破开吧，又懒得花那么大气力，因为河滩并不甚远，随便去掮一块回来，哪一块也比它强。	Hard 37 38 錾
每天回家，曲折穿过金门街到厦门街迷宫式的长巷短巷，雨里风里，走入霏霏令人更想入非非。	Hard 32 34 霏霏
至于视觉经验，也都表现得很有动感：写荷花迎风则“红披绿偃，摇荡葳蕤”，写微风拂水则“细生鳞甲”，写流萤则“（幽火）班班，若骇若惊，奄忽去来”，写山则“森森欲下搏人”。	Hard 65 69 奄忽去来
20世纪60年代的一天，周恩来总理在中南海勤政厅招待外宾，客人对中国菜肴风味之独特、味道之鲜美大为赞赏。	Complex 34 36 菜肴
店家赶出来叫道：“客官哪里去？”	Complex 9 11 客官
自然，也可以扩大精神，增加智识的，但这些倒都不计及，一计及，便等于意在赢钱的博徒了，这在博徒之中，也算是下品。	Hard 27 29 计及
本来村里还有一个老信客。	Complex 9 11 信客
一种浓酽的悔意涌上心头，他想马上找到那不见身影的老人，把钱包奉还……	Hard 2 4 浓酽
他仍是衣衫不整，仍是一面踱步一面埋头沉思。	Complex 3 7 衣衫不整
围着看热闹的细娃们，哈哈大笑，为刘伯承的胜利喝彩。	Complex 22 24 喝彩
而笼子里换上了一只小豹，即使感觉最迟钝的人看到在弃置了如此长时间的笼子里，这只凶猛的野兽不停地蹦来跳去，他也会感到赏心悦目，心旷神怡。	Complex 62 66 心旷神怡
它的眼睛闪闪有光，并且目光十分坦率；它的耳朵也长得好，并且不大不小，不像牛耳太短，驴耳太长；它的鬣毛正好衬着它的头，装饰着它的颈部，给予它一种强劲而豪迈的模样；它那下垂而茂盛的尾巴覆盖着、并且美观地结束着它的身躯的末端：马尾和鹿、象等的短尾，驴、骆驼、犀牛等的秃尾都大不相同，它是密而长的鬃毛构成的，仿佛这些鬃毛就直接从屁股上生长出来，因为长出鬃毛的那个小肉桩子很短。	Hard 144 146 鬃毛
我心里还愤愤的，以为惩戒得还没有快意。	Hard 16 18 快意
杀好了腰，再穿上肥腿的白裤，裤脚用鸡肠子带儿系住，露出那对"出号"的大脚！	Hard 17 20 鸡肠子
荀子阐发孟子的人伦说，提出“群居和一”之道（《荀子・荣辱》），作为人类生活的基本准则。	Hard 14 18 群居和一
况且如今这个货也短，你就拿现银子到我们这不三不四的铺子里来买，也还没有这些，只好倒扁儿去。	Hard 40 44 倒扁儿去
你看田间那些挥镰的农民，弯着腰，流着汗，只想着快割，快割;麦子上场了，有想着快打，快打.	Complex 6 8 挥镰
屋顶的坡度就随着这挙架，由下段的檐部缓和的坡度逐步增高为近屋脊处的陡斜，成了缓和的弯曲面。	Hard 9 11 挙架
一直奔到大海，仍然毫无惧色，纷纷跳将下去，被汹涌澎湃的波涛吞没，直到全军覆没为止。	Complex 9 13 毫无惧色
“公等”是指徐霞客一行冒雪攀山的游客，仰见下山的群僧，乃有“冉冉僧一群从天而下”的奇句，虽武侠片也	Hard 30 32 冉冉
据说他是古代的巨富之一，他的名字已成为“富豪”的同义语。	Complex 7 9 巨富
河蚌急忙把壳儿合上，牢牢地夹住鹬的嘴不放。	Hard 15 16 鹬
哪有酿葡萄酒还要放酒药的道理？	Hard 9 11 酒药
章太炎笑了笑，说都不是。	Complex 0 3 章太炎
如有过往客商人等，可于巳、午、未三个时辰，结伴过冈。	Hard 11 12 巳
将来，也许会有地心飞船找到‘落日六号’并同它对接，但愿那时我留下的资料会有用。	Hard 22 24 对接
狠心的宙斯又派了一只凶恶的鹫鹰，每天站在普罗米修斯的双膝上，用它尖利的嘴巴，啄食他的肝脏。	Complex 38 40 啄食
从前有一个叫砰砰城的国家，那里是世界上最吵闹的地方。	Complex 6 9 砰砰城
提了一条齐眉短棒，奔出南门，一道烟走了。	Hard 14 17 一道烟
那条白线很快地向前移动，逐渐拉长，变粗，横贯江面。	Complex 20 24 横贯江面
雪花落在积得厚厚的雪褥上面，听去似乎瑟瑟有声，使人更加感得沉寂。	Complex 9 11 雪褥
他和妈妈把爸爸的骨灰盒请回来，放在爸爸生前读书的写字台上，那顶象征和平的蓝盔搁置其上。	Hard 36 38 蓝盔
这时他才发现，那不是一块黑板，而是一辆马车车厢的后壁。	Hard 24 26 后壁
刘：各位听众，这时候我们看到直升机已经飞抵落点上方，对火箭落水瞬间施放的荧光染色剂进行精度照相测量。	Hard 43 45 精度
这位官员的运气并不比头一位钦差大臣好：他看了又看，但是那两架空织布机上什么也没有，他什么东西也看不出来。	Complex 13 17 钦差大臣
拯救了这条生命我多么高兴啊！	Complex 0 2 拯救
一个好心肠的老伯伯走过来问小姑娘：“孩子，你在等谁呀？”	Complex 2 5 好心肠
来年的春上，法桐又长满了叶子，依然是浅绿的好，深绿的也好。	Complex 6 8 法桐
大禹治水，受到各部落拥戴，于公元前21世纪建立了夏朝。	Complex 10 12 拥戴
只有萨伐河上的一座桥和那个小小的桥头堡还在德国人手里。	Complex 2 5 萨伐河
这是一个有雾的日子，中午的时候，累赘的包袱压得他受不了。	Complex 19 21 包袱
有弗学，学之弗能弗措也；有弗问，问之弗知弗措也；有弗思，思之弗得弗措也；有弗辨，辨之弗明弗措也；有弗行，行之弗笃弗措也。	Hard 0 3 有弗学
就这样，鹬蚌相持着，谁也不让谁。	Hard 4 8 鹬蚌相持
每个牧人都不知道自己是歌唱家。	Hard 2 4 牧人
缅伯高晓行夜宿，餐风饮露，来到陕西沔阳，离京城已经不远，见一片湖水在前，十分清澈。	Complex 0 3 缅伯高
在布热金卡，本来不该有阳光照耀，不该有光亮，不该有碧绿的草地，不该有孩子们的嬉笑。	Complex 13 15 照耀
我们只能在樵夫的茅草房的烟囱里偶尔看见冒出几缕黑烟，谁能分得出那一缕是树苗的，那一缕是茅草的化身？	Complex 5 7 樵夫
从五言律诗到七言律诗，问题很简单：只消在每句前面加上平仄相反的两个字就成了。	Hard 26 28 平仄
此封短短的信给了我极大的感情震荡。	Complex 14 16 震荡
我们沿着小路来到井房。	Complex 8 10 井房
我空着肚子，又推了几步，实在推不动了，产生了“偷劲”的念头。	Hard 23 25 偷劲
忽而一个红衫的小丑被绑在台柱子上，给一个花白胡子的用马鞭打起来了，大家才又振作精神的笑着看。	Complex 37 41 振作精神
但是让我们剖开一只蟋蟀看看吧。	Hard 9 11 蟋蟀
那朵红莲，被那繁密的雨点，打得左右欹斜。	Hard 17 19 欹斜
需要在这一段的开头加上一两个句子，使上下文衔接自然，紧密贯通。	Complex 26 30 紧密贯通
在春暖时节，有一夜，我在睡梦中好像听到小院书房的窗纸响，第二天发现窗棂上果然撕破了一个洞，显然地是有野猫钻了进去。	Hard 33 35 窗棂
梁思成第一个抓住铁索，两腿悬空地往刹尖攀援。	Hard 17 19 刹尖
他发现：根据爱因斯坦的公式，铀的链式反应所释放出的能量，威力比普通炸弹不知高出多少倍，刹那间，能把干万生命烧成灰烬。	Hard 14 15 铀
事后我追想为什么会有那样大的感情震荡，是为了民族而自豪？	Complex 16 18 震荡
根据这个传说，人们用“杏林”称颂医生，用“杏林春满”或“誉满杏林”等成语来赞扬医生的高明医术和高尚医德。	Complex 28 32 誉满杏林
小朋友临走时，槐乡的孩子还会送他一大包蒸过晒干的槐花，外加一小罐清亮清亮的槐花新蜜。	Hard 39 41 新蜜
我一时不知所措,窘得满脸通红。	Complex 3 7 不知所措
看吧，狂风紧紧抱起一堆巨浪，恶狠狠地扔到峭崖上，把这大块的翡翠摔成尘雾和水末。	Complex 20 22 峭崖
由此可见，用螫针重复刺三次，真是再符合逻辑不过的了。	Hard 6 8 螫针
他整天呆在邯郭的大街上，看人家走路，边看边琢磨人家走路的特点，还跟在后边模仿。	Complex 21 23 琢磨
因为他身上穿的还是那样一种浅蓝的土靛染的粗布裤褂。	Hard 16 18 土靛
这一篇讲演分三次讲完，每次讲过，先生大汗淋漓，状极愉快。	Complex 23 27 状极愉快
“三十二个鬼子……”	Hard 5 7 鬼子
据说住在竹楼上面，急雨声如瀑布，密雪声比辟玉。	Hard 19 22 比辟玉
黄山最妙的观松处，当然是曾被徐霞客称为“黄山绝胜处”的玉屏楼了。	Complex 22 25 绝胜处
经过了寂寞的冬天，到了第二年，春水盈塘，绿柳垂丝，一片旖旎的风光。	Complex 27 29 旖旎
唐朝的都城长安是当时最大的国际都会，在人世纪前半叶，人口已经达到百万之多，居住着不少任职于唐朝的外国人、留学生、学问僧、求法僧、外国的艺术家，以及大量外来的商贾。	Hard 15 17 都会
有些猛一看与耳朵的形状相差甚远，但是考虑到外耳奇特的构造，那些字形的样子也就不足为怪了。	Complex 11 15 相差甚远
这些作品虽成过去，却仍虎虎有神，正如唐人郭震所形容的：“虽复尘埋无所用，犹能夜夜气冲天。”	Hard 28 35 虽复尘埋无所用
当人们旅行得渴不可耐的时候，忽然看见一个很大的湖，里面蓄着碧蓝的清水，看来并不很远。	Complex 27 29 蓄着
孙中山小的时候在私塾读书．那时候上课，只是先生念，学生跟着读，然后把读的段落背诵下来．至于书里的意思，先生从来不讲解。	Complex 8 10 私塾
在凉山彝族群众心目中，火是圣物，它能够净化一切。	Complex 3 5 彝族
刘鹗先生是个很有文学天才的人；他的文学见解也很超脱。	Hard 0 2 刘鹗
但我跟他的差距越来越小，我屡屡拿第二，而约翰逊总是第一！	Complex 13 15 屡屡
若果他那文章还值得称引，我们尚可以就“沅有芷兮澧有兰”与“乘舲上沅”这些话，估想他当年或许就坐了这种小船，溯流而上，到过出产香草香花的沅州。	Hard 29 33 乘舲上沅
“蜀道之难难于上青天”，“天姥连天向天横”，这个“上青天”、“向天横”都是直上直下将人的生命与宇宙生命相贯通。	Hard 13 20 天姥连天向天横
四叔皱了皱眉，四婶已经知道了他的意思，是在讨厌她是一个寡妇。	Hard 27 29 寡妇
旧籍记载荔枝，说到有的品种皮粗厚，刺尖，唐代徐夤诗云“龙绢壳绽红纹粟”，就已观察到这种构造。	Hard 22 24 徐夤
所以家乡老辈都说我“像个先生样子”，遂叫我做“穈先生”。	Hard 23 26 穈先生
代表本地的出产，边街上有几十家玉器作，用珉石染红着绿，琢成酒杯笔架等物，货物品质平平常常，价钱却不轻贱。	Hard 20 22 珉石
贾芸便呆呆的坐到晌午，打听凤姐回来。	Hard 8 10 晌午
“诸位爱卿，”他颓丧地向他的四位枢密参赞说道，“在寡人登基三十周年纪念的今天，竟有歹徒将一封黑信投进了寡人所乘的马车。	Hard 16 20 枢密参赞
野生状态中，在阳光强烈的地方，红、橙、黄花反射了热效应大的长光波，不致引起灼伤，有保护的作用。	Hard 24 27 热效应
民间所传二十八宿，即刘秀的二十八个主要干部，多是出生于南阳一带。	Hard 4 8 二十八宿
抬头一看，一座八角宝塔形的三层建筑耸立在半山腰上，黄色的琉璃瓦闪闪发光。	Complex 31 35 闪闪发光
要是暂时经过苦难，重新克服了困境，就会说：“两岸猿声啼不住，轻舟已过万重山！”	Hard 26 27 啼
等它吃过一口饭，踏着方步去喝水、吃泥、吃草的当儿，狗就敏捷地跑过来，努力地吃它的饭。	Hard 10 12 方步
葛修润站起来：“我想耽误一会儿大家的吃饭时间，再谈谈白鹤梁的保护问题。”	Complex 10 12 耽误
“推”固然显得鲁莽一点，但是它表示孤僧步月归寺，门原来是他自己掩的，于今他“推”。	Complex 17 20 孤僧步
大圣不恋战，只情跑起。	Hard 6 10 只情跑起
是在我们结婚的大喜之日，她的“拜钱”。	Hard 15 17 拜钱
但是这个估算值仍然只达到要使宇宙重新坍缩的临界质量的百分之十左右。	Complex 4 7 估算值
（《礼记・坊记》）范仲淹所说“先天下之忧而忧，后天下之乐而乐”＂（《岳阳楼记》）也体现了这种精神。	Hard 15 22 先天下之忧而忧
诸葛亮说：“都督委托，当然照办。	Complex 6 8 都督
不少君主重视求谏，尧设诽谤之木，舜悬招谏之鼓；封建时设立谏诤机构，付薪水养了一批谏议大夫、拾遣、补阙、正言之类的官员专挑皇帝的毛病，都是对批评稀缺的补救措施。	Complex 45 47 拾遣
尽管如此，万户那种勇于实践的探索精神，却使人们的内心深处受到了极大的震撼和鼓舞，他因此被国际航天史学家公认为人类升空探索的先驱。	Complex 9 13 勇于实践
这却不然，责任是要解除了才没有，并不是卸了就没有。	Hard 2 4 不然
敬畏它们，就是敬畏宇宙，敬畏自然，就是敬畏我们自己。	Complex 7 9 敬畏
周旋了许久，东郭先生伯天黑了，野独越来越多，就对狼说：“民间风俗，凡事先问三老，如果三老说行，我没话说，如果反对，你说算了。”	Hard 15 17 野独
席散时，会首给每个人分一条印花手帕。	Complex 4 6 会首
汉武帝曾筑扶荔宫，把荔枝移植到长安，没有栽活，迁怒于养护的人，竟然对他们施以极刑。	Complex 23 26 迁怒于
“年”见了桃符，听到爆竹响，吓得赶快逃跑，这样大家就安然无恙了。	Hard 5 7 桃符
每年秋天，我的庶祖母同我到田里去“监割”（顶好的田，水旱无忧，收成最好，佃户每约田主来监割，打下谷子，两家平分），我总是坐在小树下看小说。	Hard 36 38 佃户
几十年前，我小的时候，老鸹是北京一景。	Hard 11 13 老鸹
浉河依傍着家乡的城镇。	Hard 0 2 浉河
楚王看见了，问他们：“那个囚犯犯的什么罪？	Complex 13 15 囚犯
冈重岭复，乔木苍苍。	Hard 0 4 冈重岭复
原来，司马迁因为替一位将军辩护，得罪了汉武帝，入狱受了酷刑。	Complex 16 18 得罪
玄德正看间，忽闻吟咏之声，乃立于门侧窥之，见草堂之上，一少年拥炉抱膝，歌曰：	Complex 30 32 拥炉
“只要他们有了火，”普罗米修斯对自己说，“他们至少就可以取暖和做饭了；他们还可以学会制造工具，给自己盖房子住。	Complex 10 15 普罗米修斯
父亲板起了面孔，对我说：“把书本拿来，我考考你。”	Complex 2 3 板
我大姨妈及妈妈相偕下班回家，看见一个小妖精在大门口跳橡皮筋，满头万国旗飞舞，先是前俯后仰，及看清是我，差点背过气去。	Hard 7 9 相偕
人们在河边涮洗着衣服和新摘下来的青菜；每当傍晚时分，酷爱清洁的女人们就会来到河里洗澡，平日里穿的五颜六色的筒裙，这时变成了一个个色彩斑斓的“浴罩”浮在水面上，她们有时还在水中嬉戏，在夕阳的映衬下，更显出几分妩媚。	Complex 26 28 酷爱
在洋车夫里，个人的委屈与困难是公众的话料，"车口儿"上，小茶馆中，大杂院里，每人报告着形容着或吵嚷着自己的事，而后这些事成为大家的财产，象民歌似的由一处传到一处。	Complex 18 20 话料
秦俑的制作充分体现了中国古代发达的科学技术，令许多国外的科学史家惊叹不已。	Complex 32 36 惊叹不已
突然，小伙伴“哎哟”一声叫起来，原来是螃蟹用大螯夹住了他的手。	Hard 22 24 大螯
白头鸟在林边的鸣叫声不断传来，锯木厂的后面，黎贝尔草地上，普鲁士军队正在操练。	Hard 36 38 操练
每天，小朋友们拍着长队，等着跟它们合影留念。	Complex 17 21 合影留念
小螃蟹又哭了，不过这次他哭得很开心。	Complex 1 3 螃蟹
所以创业的都是年轻人，我们需要一种风险投资的基金来支持创业者，要看到这个趋势。	Complex 36 38 趋势
晋国的国君晋文公向大臣狐偃请教用兵的策略：“现在敌众我寡，对我们很不利，我们怎么做才能取胜呢？”	Complex 24 28 敌众我寡
我并不因此大惊小怪。	Complex 5 9 大惊小怪
时云长在侧曰：“某闻管仲、乐毅乃春秋、战国名人，功盖寰宇；孔明自比此二人，毋乃太过？”	Hard 8 12 某闻管仲
抱着大树，我又感到自己是一只动物，我是一条小蜥蜴，爸爸是一只大猿猴。	Complex 31 33 猿猴
黄与绿主宰着，无边无垠，坦荡如砥，这时如果不是宛若并肩的远山的连峰提醒了你(这些山峰凭你的肉眼来判断，就知道是在你脚底下的)，你会忘记了汽车是在高原上行驶。	Hard 12 16 坦荡如砥
他要扎的只是肉，可是鲨鱼的皮很结实，好不容易才把刀子戳进去。	Complex 26 27 戳
却说北京大名府梁中书，收买了十万贯庆贺生辰礼物完备，选日差人起程。	Complex 28 32 差人起程
长空的大风经过这里，停下了脚步。	Complex 0 2 长空
缺乏分析判断力的人，他可以研习形而上学，因为这门学问最讲究繁琐辩证。	Hard 15 19 形而上学
作为回敬，我也告诉他，舞台上失去他是多么遗憾。	Complex 20 22 遗憾
哈姆莱特请您不要这样多礼。	Complex 0 4 哈姆莱特
神像是五个男人，也不见有什么猖獗之状；后面列坐着五位太太，却并不“分坐”，远不及北京戏园里界限之谨严。	Complex 14 18 猖獗之状
桌子也是后来才有的，古代只有“几”“案”，都是很矮的，适应席地而坐的习惯，后来坐高了，几案也不得不加高，于是有了新的名称，最初就叫“卓子”(“卓”是高而直立的意思)，后来才把“卓”写做“桌”。	Complex 66 68 卓子
白竹布衬衫小凉帽，绣花兜肚彩头巾。	Complex 11 13 兜肚
可能，谁能保证呢，也许是个随葬的奴隶或驭手。	Complex 13 15 随葬
何满子整天在运河滩上野跑，头顶着毒热的阳光，身上再裹起兜肚，一不风凉，二又窝汗，穿不了一天，就得起大半身痱子。	Complex 52 54 痱子
夏洛克，把我的本钱还我，放我去吧。	Complex 7 9 本钱
郑和出使，促进了我国和亚非许多国家的经济文化交流和友好往来，直到现在，有关国家还流传着三宝太监下西洋的故事。	Complex 2 4 出使
鲁智深松开手臂，拿过杨志手中的禅杖，抡起一杖将邓龙打死，众喽罗纷纷跪地投降。	Complex 18 19 抡
东海龙王父子称霸一方，经常兴风作浪，害得人们不敢下海捕鱼。	Complex 13 17 兴风作浪
于是分头四出，寻黑矮汉，寻梢长大汉，寻头陀，寻胖大和尚，寻茁壮妇人，寻姣长妇人，寻青面，寻歪头，寻赤须，寻美髯，寻黑大汉，寻赤脸长须。	Complex 19 21 头陀
哈尔穆拉特虽说已经四十岁了，还是个火暴性子，听了老爹的批评立即把头上戴的紫绒小花帽摘下，露出剃光了的尖而小的头。	Complex 17 21 火暴性子
我有犯罪感：感到是我杀害了那些孩子。	Complex 2 5 犯罪感
凤姐备好一圈坐椅，让边吃酒边行令，等待梨香院的戏开台。	Hard 14 16 行令
天，这时全黑下来了，银幕被灯光打得灿亮无比，显得更宽了。	Complex 10 12 银幕
三星期以后，这个人躺在“白德福号”的床铺上，眼泪顺着他瘦削的面颊往下淌，他说出他是谁和他经历的一切。	Complex 27 29 瘦削
凤娇骂着，眼睛却不由自主地朝第三节车厢的车门望去。	Complex 8 12 不由自主
这个年轻姑娘仿佛是规矩女人的完美无缺的典型，每一个明智的年轻人都梦想着把自己的一生托付给这种典型的女人。	Complex 14 18 完美无缺
姚文的“下有红光，动摇承之”十分高明，把动感表现得灵活之至。	Hard 6 8 红光
他说：“我希望政府向携带艾滋病病毒的孕妇提供艾滋病药物，使她们不再把病毒传染给自己的孩子。”	Hard 12 15 艾滋病
他捧给玛丽一卷用三色丝带扎好的羊皮纸文件，把用绸带悬着的金钥匙挂在她的脖子上，这就是那个装着一克镭的铅匣子的钥匙。	Hard 48 49 镭
同是这座树林，当晚秋山鹬飞来的时候，显得多么美好啊！	Hard 9 12 秋山鹬
这儿应该有几声胡笳和羌笛的，音色极美，与自然浑和，夺人心魄。	Hard 7 9 胡笳
普罗米修斯这个人类伟大的朋友，这个曾经把火带给人类，使人类脱离了苦海、教会了人类怎么生活的伟大英雄，如今却身缠铁链被栓在山崖上。	Complex 58 59 栓
忽见一人，容貌轩昂，丰姿俊爽，头戴逍遥巾，身穿皂布袍，杖藜从山僻小路而来。	Hard 27 29 杖藜
不要连续不断地开玩笑，说俏皮话，讲笑话，弄得旁边的客人心烦，尤其是重复别人已经说过、听你说话的人已经听过的笑话，那更加让人厌倦。	Complex 12 15 俏皮话
真要勉用文字来着色，也不过像谢灵运的一些名句“云日相晕映，空水共澄鲜”或是“出谷日尚早，入舟阳已微。	Hard 23 28 云日相晕映
从前，有个人种了一棵葫芦。	Complex 10 12 葫芦
我更高兴的更安慰的是：多少过分的谀诃与夸奖，都没有使你丧失自知之明，众人的掌声、拥抱，名流的赞美，都没有减少你对艺术的谦卑！	Hard 16 18 谀诃
这也是千古名句，可是这里的“高树多悲风”却并没有落叶的形象，而“寒风扫高木”则显然是落叶的景况了。	Hard 32 37 寒风扫高木
精神上感到满足自在时，它们可以闪闪发光，转眼又因忧郁而黯然失色，罩上阴云，顿生凄凉，显得麻木不仁神秘莫测。	Complex 44 48 麻木不仁
疲劳加上忧愤，使肖邦的肺结核病又复发了。	Complex 11 15 肺结核病
城破时，史可法要拔刀自刎，手下众将争着抱住他，史可法大声呼史德威动手，史德威泪如雨下，不能举刀。	Hard 10 12 自刎
地平线上那一轮胭脂色的物什，终于从我们的眼前魔术般消失，一切又重归于死寂。	Complex 7 10 胭脂色
这时舷窗已经烧得黑乎乎的，我坐在里面，怀抱着操作盒，屏息凝神地等待着配合程序：到哪里该做什么，该发什么指令，判断和操作都必须准确无误。	Hard 2 4 舷窗
村长在嘎羧脖子上系了一条洁白的纱巾，四条象腿上绑了四块黑布。	Hard 3 5 嘎羧
我觉得小姐眼中仿佛含着泪水，而他注视着列车驶去，直到看不见时才转过身来，我发现他确实泪水盈眶。	Complex 42 46 泪水盈眶
武松回到青石上坐了半歇，想道：“天色看看黑了，如果再跳出一只大虫来，却怎么斗得过？	Hard 9 11 半歇
1979年春，中国科学院武汉水生生物研究所的科学家，用鲫鱼囊胚期的细胞进行人工培养，经过385天59代连续传代培养后，用直径10微米左右的玻璃管在显微镜下从培养细胞中吸出细胞核。	Complex 27 31 鲫鱼囊胚
那歌声真好听，赛过催眠曲，让那些辛苦一天的人们，甜甜密密地进入梦乡。	Complex 9 12 催眠曲
在第四段“潜心学书法”和“也是重视基本功的训练的”后面，可以分别加上“开始时从点、横、撤、捺练起”，“他苦练了一个个寒冬酷暑，每次练完就到池边洗笔，天长日久，竟把池水染黑了这样添改后，论据就显得具体、生动一些，不致过于简略。	Hard 43 44 撤
一个人呷了一口酒，幽幽地提出疑问。	Hard 9 11 幽幽
翻耕的犁铧激起一行行土浪，上升到地表的土壤形成整齐而粗大的线条，这些斑纹，是即将受孕的标记。	Hard 3 5 犁铧
我真不知道还有没有比列宁格勒更残酷的围城。	Complex 18 20 围城
部队今天非夜里行军不可，她的房子和篱笆都是枯竹编成的，我们生怕有人拆下来当火把点，就写了几条标语，用米汤贴在外面显眼的地方，告知我们的部队不准拆篱笆当火把。	Complex 7 9 行军
请您赏脸把这件衬衫穿上，还有这套衣服；正合适，好极了——又素净，又讲究，又雅致，简直就像个公爵穿得那么考究。	Complex 37 39 雅致
种橡树，种山毛榉，还种白桦树。	Hard 5 8 山毛榉
今文若何为美，若何为不美，若何则适于口而顺于耳，若何则仅供目治，违于口耳，倘能举例而申明之，归纳为若干条，诚如流行语所称大有现实意义。	Hard 29 31 目治
九色鹿生性忠厚，心中还有点怀疑白鸟的警告，没来得及躲避，就被千军万马重重包围住了。	Complex 3 7 生性忠厚
那声音大概是横笛，宛转，悠扬，使我的心也沉静，然而又自失起来，觉得要和他弥散在含着豆麦蕴藻之香的夜气里。	Complex 36 38 弥散
统领、他的侄子、为枪手发令的中尉、一个医生和一个牧师已经站在院中了，他们一本正经地往前走着，看到牛虻含笑的眼睛中光芒四射的蔑视，他们都有些局促不安。	Hard 48 50 牛虻
例如《诗经·鲁颂》的《駉》这一首诗里提到马的名称就有16种：“驈”(身子黑而胯下白的)，“皇”(黄白相间的)，“骊”(纯黑色的)，“黄”(黄而杂红的)，“骓”(青白杂的)，“駓”(黄白杂的)，“騂”(红黄色的)，“骐”(青黑成纹像棋道的)，“驒”(青黑色而有斑像鱼鳞的)，“骆”(白马黑鬃)，“駵”(红马黑鬃)，“雒”(黑马白鬃)，“駰”(灰色有杂毛的)，“騢”(红白杂毛的)，“驔”(小腿长白毛的)，“鱼”(两眼旁边毛色白的)。	Hard 77 78 骓
我想，用图画来比方，对称的建筑是图案画，不是美术画，而园林是美术画，美术画要求自然之趣，是不讲究对称的。	Complex 27 29 园林
大树下又支起一杆大秤来，两个大汉抬着，由村上德高望重的长辈看秤花，立夏节的称人活动便开始了。	Complex 22 26 德高望重
它生动地描写景物，然而它不是一般的风物画，不是“赋”，不那么直观、真实。	Complex 24 25 赋
今年的诺贝尔奖的获得者有：德国的伦琴（物理学奖），他发现了X射线；荷兰的范托夫（化学奖），他发现了化学动力学定律和渗透压定律；德国的贝林（生理学或医学奖），他在血清法的研究方面卓有成就；法国的普吕多姆（文学奖），他在诗歌创作方面颇有建树。	Complex 114 118 颇有建树
老头儿看见两个褐色的鳍顺着死鱼的水里所不得不造成的那条宽阔的路线游着。	Hard 10 11 鳍
“多利”不是由母羊的卵细胞和公羊的精细胞受精的产物，而是“换核卵”一步一步发展的结果，因此是“克隆羊”。	Complex 47 49 克隆
田老师的声音戛然而止，我却仍在发呆，直到三年级的大学兄捅了我一下，我才惊醒。	Complex 27 28 捅
过了一个月，老狐狸和正太郎熟悉了，有时家里没有别人，正太郎的屋门就会轻轻响一声，两只狐狸从门缝里挤进来，舔正太郎的手，轻松自在地在屋里慢腾腾地踱来踱去。	Complex 10 13 正太郎
何满子吱吱喳喳欢迎爷爷，爷爷一点也不欢喜，没有抱他，也没有亲他，捎马子空空荡荡只有两层皮。	Complex 35 39 空空荡荡
宫顶建筑摒弃了巴罗克的圆顶和法国传统的尖顶建筑风格，采用了平顶形式，显得端正而雄浑。	Hard 39 41 雄浑
老奶奶说：“下雨天是坏天气，因为大儿子不能晒果脯了；大晴天也是坏天气，因为小儿子的雨伞就卖不出去了。”	Complex 22 24 果脯
当时三人坐下，李逵便道：“酒把大碗来筛，不奈烦小盏价吃。”	Hard 23 27 小盏价吃
如果在人身上做，成功率可能更低，而且很可能会产生出许多畸形的、具有严重缺陷的克隆人。	Complex 38 41 克隆人
这个人在西班牙打过仗，在法国集中营待过两年，在战争期间又秘密地从法国回布拉格来的，————不，这种人是不会叛变的。	Complex 53 55 叛变
元刘信将三岁痴儿抛入蘸纸火盆，妄希福佑，是见于《元典章》的；剧本《小张屠焚儿救母》却道是为母延命，命得延，儿亦不死了。	Hard 15 19 妄希福佑
飞禽猛兽啄的啄，咬的咬，一时三刻，把兵马扫荡得干干净净，只剩下国王、喇嘛和那忘恩负义的人，跪在禽兽当中。	Complex 20 22 扫荡
幽兰吐秀乔林下，仍自盘根众草傍。	Hard 14 15 傍
它不仅仅成了波兰人朝拜的圣地，举行精神宴会的殿堂，参观游览的古迹，而且为数众多的外国音乐家、钢琴家、作曲家都把造访这个伟大艺术家的摇篮、这个喷射出了肖邦伟大音乐的不竭源泉，看成自己一生的夙愿。	Hard 9 11 朝拜
我眺望四周，一片茫无边际的蔚蓝的海，无数波浪闪耀着金鳞；头上，也是这样茫无边际，这样蔚蓝的海——在那儿，温柔的太阳在运行着，宛然在微笑。	Hard 25 27 金鳞
从此,马拉松这个距离雅典约42千米的海边小渔村逐渐被人们知晓。	Complex 28 30 知晓
贾母急的搂了宝玉道：“孽障！	Hard 11 13 孽障
海风吹来，绿浪翻滚，欢迎我这来自北国的远客。	Complex 19 21 远客
所以，医生们十分重视肠鸣音，特别是胃肠手术后听到肠鸣音就表示胃肠功能已恢复。	Complex 24 27 肠鸣音
孔子回答说：“子贡嘛，挺聪明的，我不及他。”	Complex 7 9 子贡
其出不出，间不容发。	Hard 5 9 间不容发
这些作品虽成过去，却仍虎虎有神，正如唐人郭震所形容的：“虽复尘埋无所用，犹能夜夜气冲天。”	Hard 36 43 犹能夜夜气冲天
“颠”有顶端之意，顶端倒过来，就说“颠倒”，波动的说“颠顿”，乱动的说“疯颠”。	Complex 36 38 疯颠
学问是寸积铢累而来的，常是各有疆域独自为政的。	Complex 3 7 寸积铢累
地平线上那一轮胭脂色的物什，终于从我们的眼前魔术般消失，一切又重归于死寂。	Complex 11 13 物什
但自从被《申报》重金礼聘去当总编辑以后，也许是四为报受到立完派的张謇等影响过多、控制过严吧，他以“冷”的署名写的“时评”和“小言”，吞吞吐吐，有时简直不知所云，真如一般人批评的，看了像读《太上感应篇》一般，《时事新报》有署名“东荪”的评论，似乎言之有物，但文词啰嗦，不着边际。	Complex 75 79 不知所云
一家人的生活全压在他肩膀上。	Complex 10 12 肩膀
队伍翻过了一座大山，眼前是一块平坦的山场，贺龙同志仔细观察了地形，然后传了一道命令，要全体指战员把草帽摘下丢在路边。	Hard 45 48 指战员
再看爸爸，他像老虎一样直瞪着我，哎哟，一根开花的小桃枝迎面插在他梳得油光光的头发里。	Complex 12 14 瞪着
真君撞进门，大圣见了，现出本相道：“郎君不消嚷，庙宇已姓孙了。”	Hard 20 23 不消嚷
真要勉用文字来着色，也不过像谢灵运的一些名句“云日相晕映，空水共澄鲜”或是“出谷日尚早，入舟阳已微。	Hard 38 43 出谷日尚早
到国外以后，在我的怀念中增添了祖国母亲。	Complex 12 14 增添
我希望读者从这粗枝大业的讨论中，可以领略运用文字所应有的谨严精神。	Complex 7 11 粗枝大业
世界上许多民族都有关于火的崇拜、火的禁忌的习俗。	Complex 13 15 崇拜
它把西瓜的瓤涂红了。	Hard 5 6 瓤
鹅听见了，就竖起头来，侧着眼睛看了看，竟爬到岸上，一摇一摆地、神气地走过来；还伸长脖子，“吭吭”地叫着，扑打着大翅膀，好像眼里根本没有我们似的。	Complex 25 29 一摇一摆
街道既那么窄，结果站在最前线上的特派员同四十多个青年学生与农民，便全在城门边牺牲了。	Hard 16 19 特派员
我一时不知所措,窘得满脸通红。	Hard 8 10 窘得
从窗内往外看时，那一朵白莲已经谢了，白瓣儿小船般散飘在水面。	Complex 24 26 散飘
我常为现在我院中的那两只大呆鸟感到难过，它们似乎已经没有了日升飞出日落飞回的习惯，大白天都蹲在城里无所事事，而且也不敢肆无忌惮地大叫，老鸹不老呱了，怪可怜的。	Hard 67 72 老鸹不老呱
一方的异彩，揭去了满天的睡意，唤醒了四隅的明霞——光明的神驹，在热奋地驰骋。	Hard 18 20 四隅
裂片大小疏密，片峰尖平，都因品种而不同。	Complex 2 6 大小疏密
有弗学，学之弗能弗措也；有弗问，问之弗知弗措也；有弗思，思之弗得弗措也；有弗辨，辨之弗明弗措也；有弗行，行之弗笃弗措也。	Hard 48 51 有弗行
书主被糟蹋到这种程度，怎能不潸然泪下欤。	Hard 14 18 潸然泪下
大约半月后的一天下午，刘伯承又同几个穷家小户的细娃在张家河坝嬉耍。	Complex 30 32 嬉耍
后来它们言归于好，又开始像原先那样痴呆地进行工作，但是那只瘸腿的蚂蚁老大吃亏，无论它怎样使大劲拽，另一只蚂蚁仍旧把那胜利品连同吊在末端上的它一起拉了过去。	Complex 4 8 言归于好
山岚云气漫入车窗又溢出车厢而去。	Complex 0 2 山岚
时云长在侧曰：“某闻管仲、乐毅乃春秋、战国名人，功盖寰宇；孔明自比此二人，毋乃太过？”	Hard 24 28 功盖寰宇
天越冷越好，浆得野鸡连眼睛都睁不开。	Hard 6 7 浆
过了好几个礼拜，这个可怜的家伙才渐渐从它因长期禁锢所受的精神虐待中恢复过来。	Complex 23 25 禁锢
是在我没有一点准备、一丝预料的时刻，宇宙便把它那无与伦比的光华、丰采，全部展现在我的眼前了。	Complex 12 14 预料
我决心要揭开金蝉脱壳的秘密。	Complex 6 10 金蝉脱壳
及至始皇，奋六世之余烈，振长策而御宇内，吞二周而亡诸侯，履至尊而制六合，执敲扑而鞭笞天下，威振四海。	Hard 16 19 御宇内
小鸭只好用他的一双腿不停地游动，免得水完全被冰封住。	Complex 22 24 冰封
南极离得越来越近了，她拿着一只用蜡封严瓶口的啤酒瓶，兴冲冲跑到右舷。	Hard 31 33 右舷
深蓝色的天空里悬着无数半明半昧的星。	Complex 11 15 半明半昧
水要喷出来，或者身体哪里破了流血，它立即上去按住；护士给病人打针时它要负责把注射液推入人体；握扫帚把柄时，它要独当一面；攥、捏、握、捻、弹、揪都离不开它。	Hard 66 67 捻
希腊人民奋起反抗,以一万人对付波斯帝国的十万大军,在海边一个叫马拉松的小渔村和敌人展开了决战,结果大获全胜。	Complex 4 8 奋起反抗
英国方面同时入场并登上主席台主礼台的有查尔斯王子、首相布莱尔、外交大臣库克、离任港督彭定康、国防参谋长查尔斯·格思里。	Complex 40 42 港督
但是凤穿牡丹主题画，必在牡丹花成为人民心目里“花中之王”，而凤穿牡丹且具有春风独占的爱情喻义后，才会普遍使用作人民艺术共通的题材。	Complex 44 46 喻义
次日早起五更，在府里把担仗都摆在厅前，老都管和两个虞候又将一小担财帛，共十一担，拣了十一个壮健的厢禁军，都做脚夫打扮。	Hard 48 51 厢禁军
像鸽子笼一般地分得均匀，每边八排，每排五户，一共八十户一楼一底的房屋，每间工房的楼上楼下，平均住着三十二三个“懒虫”和“猪猡”，所以，除了“带工”老板、老板娘、他们的家族亲戚和穿拷绸衣服的同一职务的打杂、请愿警之外，这工房区域的墙圈里面住着二千左右衣服褴褛而替别人制造衣料的“猪猡”。	Hard 89 91 拷绸
月色豫胧的夜半，有一二猎夫，会效仿麂子的嘶声，往往登高一呼，麂子便成群地走来。……	Hard 17 19 麂子
那些属于所谓同属的生物都是另一个并且一般是已经绝灭的物种的直系后代，这与任何一个物种的公认的变种是该物种的后代，是同样的情形。	Hard 46 48 变种
《易经》和《老子》大部分是韵语，《庄子》等书也有一些韵语。	Hard 13 15 韵语
鲁达坐下道：“奉着经略相公钩旨，要十斤精肉，切做臊子，不要见半点肥的在上头。”	Hard 9 15 经略相公钩旨
三峡，注定是一个不安宁的渊薮。	Hard 12 14 渊薮
那个满脸横肉的便衣侦探指着父亲问阎振三：“你认识他吗？”	Hard 16 19 阎振三
很显然，这个窗户俯瞰着一座公园，公园里面有一泓湖水，湖面上照例漫游着一群群野鸭、天鹅。	Hard 21 23 一泓
就这样，我们总是为了寻开心，揪掉这些不引人注目的小花。	Complex 19 23 引人注目
例如《诗经·鲁颂》的《駉》这一首诗里提到马的名称就有16种：“驈”(身子黑而胯下白的)，“皇”(黄白相间的)，“骊”(纯黑色的)，“黄”(黄而杂红的)，“骓”(青白杂的)，“駓”(黄白杂的)，“騂”(红黄色的)，“骐”(青黑成纹像棋道的)，“驒”(青黑色而有斑像鱼鳞的)，“骆”(白马黑鬃)，“駵”(红马黑鬃)，“雒”(黑马白鬃)，“駰”(灰色有杂毛的)，“騢”(红白杂毛的)，“驔”(小腿长白毛的)，“鱼”(两眼旁边毛色白的)。	Hard 107 108 骐
旧籍记载荔枝，说到有的品种皮粗厚，刺尖，唐代徐夤诗云“龙绢壳绽红纹粟”，就已观察到这种构造。	Hard 27 34 龙绢壳绽红纹粟
李白诗云“燕山雪花大如席”，不知有几万、几十万朵雪花才能黏连成一片席那么大呢！	Hard 9 12 大如席
在随后的发育中，手指开始慢慢成长，手指之间的蹼渐渐退化。	Hard 22 23 蹼
小哪吒可机灵啦，身子一闪，躲过了这一斧头，随便取下乾坤圈，向夜叉扔去。	Hard 30 32 夜叉
宋朝的时候,有一回黄河发大水,冲断了河中府城外的一座浮桥。	Hard 26 28 浮桥
他脸上老是有菜色，	Hard 6 8 菜色
秋天，它结下了沉甸甸的种子，种子便毅然跳进了峡谷的怀抱，献身于那没有阳光的“地下”。	Complex 28 30 献身
然而令人始料不及的是，这里竟成了斑贝的“天堂”。	Complex 16 18 斑贝
当我们劝他搬家时，钱老说：“我现在的住房条件比和我同船归国的那些人都好，这已经脱离群众了，我常常为此感到不安，我不能脱离一般科技人员太远。”	Complex 39 41 脱离
假如你要报恩，那就请你回去后，不要对人说我在这里，因为人们贪图我的皮角，万一坏人知道了，一定会来伤害我的。	Hard 33 35 皮角
小芹一个人悄悄跑到前庄上去找小二黑，恰在路上碰上小二黑去找她，两个就悄悄拉着手到一个大窑里去商量对付三仙姑的法子。	Complex 42 44 大窑
母亲叫我和小帮工把曲一粒粒拣出来，不然就会愈来愈多的。	Hard 9 10 曲
溪西一带山，俱似鹦绿鸦背青，上有腥红云五千尺，开一大洞，逗出缥天，映水如绣铺赤玛瑙。	Hard 6 8 俱似
在传统的石拱桥的基础上，我们还造了大量的钢筋混凝土拱桥，其中“双曲拱桥”是我国劳动人民的新创造，是世界上所仅有的。	Hard 22 25 混凝土
去年的粜价是七块半，今年的米价又卖到十三块，不，你先生说的，十五块也卖过；我们想，今年总该比七块半多一点吧。	Hard 3 5 粜价
马路上没有人，也没有汽车，但红灯亮了，立即从自行车上下来，等在标志线前的小伙子。	Hard 31 34 标志线
金龟子发音的部位在腹部末端。	Complex 0 3 金龟子
玄德徐步而入，见先生仰卧于草堂几席之上。	Hard 15 17 几席
胶皮笔囊内没有夹管，吸墨水时，捏一下，鼓起缓慢。	Hard 2 4 笔囊
若果他那文章还值得称引，我们尚可以就“沅有芷兮澧有兰”与“乘舲上沅”这些话，估想他当年或许就坐了这种小船，溯流而上，到过出产香草香花的沅州。	Hard 19 26 沅有芷兮澧有兰
我不禁头涔涔而泪潸潸了。	Hard 7 10 泪潸潸
但是到了第二天早晨，船在绕着房总半岛转的时候，不知什么缘故，那位父亲牵着五岁的二儿子的手，无精打采地走进那财主的太太的客舱。	Complex 45 49 无精打采
香菱笑道：“我只爱陆放翁的诗‘重帘不卷留香久，古砚微凹聚墨多’，说的真有趣！”	Hard 23 30 古砚微凹聚墨多
少年曰：“某乃卧龙之弟诸葛均也。	Hard 5 15 某乃卧龙之弟诸葛均也
向下看，怪石突兀，绿树掩映，浩浩荡荡的雅鲁藏布江自西而来，然后转向，绕着南迦巴瓦峰作马蹄形大拐弯，向南奔腾而去。	Complex 11 13 掩映
他们早就形成了对他的主观概念，希望从他身上找见威严非凡的东西，希望看到一个貌似天父的美髯公，集尊贵、轩昂、伟岸、天才于一身。	Hard 42 45 美髯公
刘备叫人立即备马。	Complex 6 8 备马
因为松散而任人宰割，因为松散而过于低贱，因为松散而形不成气候，更形不成风景。	Complex 5 9 任人宰割
也幸而有各式各样的人，假如世界上全是文学家，到处所讲的不是“文学的分类”便是“诗之构造”，那倒反而无聊得很了。	Complex 4 8 各式各样
除了供查诗韵外，它还把各种物象、各种情景、各种心绪分门别类，纂集历代相关诗句，成了一部颇为齐全的诗歌词典。	Hard 30 32 纂集
然秦以区区之地，致万乘之势，序八州而朝同列，百有余年矣；然后以六合为家，崤函为宫；一夫作难而七庙隳，身死人手，为天下笑者，何也？	Hard 48 49 隳
风扇是使空气流动的唯一途径。	Complex 11 13 途径
围坐在篝火旁边的，有董必武、徐特立、谢觉哉、成仿吾、冯雪峰、邓颖超、贺子珍、李伯钊等数十名男女红军。	Complex 3 5 篝火
姚文的“下有红光，动摇承之”十分高明，把动感表现得灵活之至。	Hard 9 13 动摇承之
故乡的河流名不见经传：只是淮河上的一个小支流，她却有一个雄伟的大名——浉。	Hard 35 36 浉
妙极了，它真没有走去，我们很快就在葡萄叶儿上，磁花盆儿上，爷爷的锨刃儿上发现了。	Hard 32 35 锨刃儿
这时我第一次向地面报告飞行状态：“‘神舟五号’报告，整流罩打开正常！”	Hard 26 29 整流罩
如果和哪个人发生了不愉快的事，更要去拜访，那个人也要回访，于是大家就和好如初了。	Complex 34 38 和好如初
1910年他加入同盟会，筹款资助孙中山先生领导的辛亥革命；抗日战争爆发，他担任南洋华侨总会主席，捐资抗日，不顾危险，亲身回国考察战事、慰劳将士。	Hard 41 43 华侨
我把一张小桌子搬到外边来，很隐蔽地坐在绿森森的灌木丛中。	Complex 19 22 绿森森
一句话，生命在运动，就会发出各种各样的声音，这些声音汇合在一起，组成了一支“生命奏鸣曲”。	Complex 14 18 各种各样
后来，铁路工务段派来刘长喜——人称“老刘头”来看桥。	Hard 5 8 工务段
心下想时，只见一群媳妇丫鬟围拥着一个人从后房门进来。	Hard 11 13 丫鬟
倘若你在这样一个隆冬季节，站在小屋的前边，望着被积雪压弯了的屋顶、光秃秃的树枝、黑洞洞的窗口，你就会感到，你是和肖邦在一起。	Complex 33 36 光秃秃
河中忽然传来了刘伯承的声音：“李震同志，能架桥呀！	Complex 21 23 架桥
他环顾四周，看到一位浓眉大眼的小同学正在若有所思，就在走过去，亲切地说：“小同学，你也来说说。”	Complex 20 24 若有所思
正吃时，只听得外面必必剥剥地爆响。	Complex 9 13 必必剥剥
冈重岭复，乔木苍苍。	Hard 5 9 乔木苍苍
至此，滚滚黄河完成了曲折壮丽的漫长行程。	Complex 3 5 滚滚
小男孩摆弄了很久很久，说：“一切准备停当。”	Hard 18 20 停当
第二天早晨，医护人员送来了漱洗水，发现那个病人早已咽气了，他们静悄悄地将尸体抬了出去，丝毫没有大惊小怪。	Complex 25 27 咽气
大家立刻都赞成，和开船时候一样踊跃，三四人径奔船尾，拔了篙，点退几丈，回转船头，驾起橹，骂着老旦，又向那松柏林前进了。	Complex 42 43 橹
当我刚刚能够歪歪咧咧地提着一个篮子跑路的时候，我就跟在大姐姐身后拣麦穗了。	Complex 33 35 麦穗
可是，我却根本没把这些警告放在心上。	Complex 11 13 警告
线绕在锭子上，线穗子一层一层加大，直到大得沉甸甸的，像成熟了的肥桃。	Hard 3 5 锭子
小芹那年才九岁，晌午做捞饭，把米下进锅里了，听见她娘哼哼得很中听，站在桌前听了一会，把做饭也忘了。	Hard 11 13 捞饭
黄鸟和小巧玲珑的白眉鸫,尖声尖气地吹着笛子。	Hard 8 11 白眉鸫
画笔扑通一声浸进松节油，继而扔进蓝色和白色颜料中，在我那块调色板上疯狂地搅拌起来，然后在吓得簌簌直抖的画布上肆意汪洋地涂了好几笔蓝色。	Complex 46 50 簌簌直抖
这个敌手没有自己的网，也可能已经耗尽了积蓄下来的汁液，因而现在不得不跑来侵犯它的邻居。	Complex 19 21 积蓄
满腔热情，感人至深！	Complex 5 9 感人至深
但是，帝王却把“文死谏”和“武死战”并列，要求臣子不顾身家性命，把“犯颜直谏”当做忠臣的表率。	Hard 8 11 文死谏
还有的，因为中了暑，或是发痧，走着走着，一头栽到地上，永不起来。	Hard 12 14 发痧
收拾好你自己的一摊子。	Complex 7 10 一摊子
松鼠不像山鼠那样，一到冬天就蛰伏不动。	Hard 14 16 蛰伏
曾子还说哩：“任重而道远”，“死而后已，不亦远乎！”	Hard 20 24 不亦远乎
写一会儿，他放下笔，搓搓手，提提精神再写。	Complex 10 11 搓
崔杼等他写好,拿过竹简一看,上面写着:“夏五月,崔杼谋杀国君光。”	Hard 24 26 崔杼
独夜卧人静，风涛汹汹，直逼枕簟，鱼龙舞啸，其形声时入梦寐间，意洒然快也。	Hard 30 33 意洒然
脱皮鞋的大象一点儿也不理会女士的喊叫，用鼻子挥舞着皮鞋，绕着围观的人群转了一圈，才不慌不忙地回到那位女士身边，把皮鞋还给了她。	Complex 41 45 不慌不忙
李小二道：“官人请甚客？”	Hard 9 11 甚客
制造原子弹的工作异常危险，尤其是插雷管，万一发生问题，所有在场的人霎时就会化为灰烬。	Hard 17 19 雷管
那只大虫咆哮着，发起性来，翻身又扑起来。	Hard 8 12 发起性来
还有人燃烧砍伐来的青竹子，发出噼噼啪啪的声音和光，这就是爆竹的来历。	Complex 28 30 爆竹
只听“喳喳”声，落发知多少！	Complex 8 13 落发知多少
每到水势缓慢的洄水涡，都有鱼儿在欢快地跳跃。	Hard 7 10 洄水涡
认儿子不是好开交的呢。	Hard 6 8 开交
举人的太太，我管她叫奶奶，她很喜欢我。	Hard 0 2 举人
让我把这个链条重说一遍。	Complex 5 7 链条
唯其如此，才需要我们日以继夜，终生的追求、苦练；要不然大家做了羲皇上人，垂手而天下治，做人也太腻了！	Hard 36 42 垂手而天下治
许先生用筷子来回地翻着饭桌上菜碗里的东西，菜拣嫩的，不要茎，只要叶，鱼肉之类，拣烧得软的，没有骨头没有刺的。	Complex 39 40 拣
金镀在全部铜丝上，方法用电镀。	Hard 12 14 电镀
于是，它果然爬起来，拖着它那毫无价值的捕获物攀到了顶巅——它做这样聪明的事，有如我背着一袋面粉从海德堡去巴黎，却绕道攀登施特拉斯堡的尖塔一样。	Complex 25 27 顶巅
太阳光经过三棱镜或水滴的折射，会分成红、橙、黄、绿、蓝、靛、紫七种颜色。	Complex 5 8 三棱镜
在安造垸，他们救出了被洪水围困了三天三夜的幼儿园老师周运兰；在簰州湾，他们给攀上树梢等待了近九个小时的小江珊以生的希望……	Hard 1 4 安造垸
我们不要重蹈希腊人的覆辙，他们认为希腊精神是绝无仅有的，他们还忽视犹太精神，把外国人一律视为野蛮人，他们最后衰亡，一落千丈，就像他们的胜利顶峰曾高耸入云一样。	Complex 72 76 高耸入云
范进即将这银子交与浑家打开看，一封一封雪白的细丝锭子，即便包了两锭，叫胡屠户进来，递与他道："方才费老爹的心，拿了五千钱来。	Hard 24 26 锭子
成就的太小、高低，是不在我们掌握之内的，一半靠人力，一半靠天赋，但只要坚强，就不怕失败，不怕挫折，不怕打击，不管是人事上的，生活上的，技术上的——打击；从此以后你可以孤军奋斗了。	Complex 29 31 天赋
鲁智深和杨志从此当了山寨寨主。	Complex 10 12 山寨
他们的草屋，稀稀疏疏的在雨里静默着。	Complex 6 10 稀稀疏疏
手臂很长，此时无事可做，垂下来，抱着身体。	Complex 12 13 垂
一位中国诗人说：“言有尽而意无穷。”	Hard 9 16 言有尽而意无穷
天空是暗的，但雨却闪着光；田野是静的，但雨在倾诉着。	Complex 22 24 倾诉
她笑着用两手在冷水里刨抓。	Complex 10 12 刨抓
有一种叫作“碳纳米管”的神奇材料，比钢铁结实百倍，而且非常轻，将来我们有可能坐上“碳纳米管天梯”到太空旅行。	Complex 41 47 碳纳米管天梯
我这熊熊地燃烧着的生命，我这快要使我全身炸裂的怒火，难道就不能迸射出光明了吗？	Complex 31 33 迸射
田间与灌木篱下，横陈着田凫、椋鸟、画眉等数不清的腐鸟的血衣，鸟儿的肉已被隐秘的老饕吃净了。	Complex 24 26 腐鸟
手术完成之后，用相同频率的电脉冲刺激换核卵，让苏格兰黑面羊的卵细胞质与芬多席特母羊乳腺细胞的核相互协调，使这个组装细胞在试管里经历受精卵那样的分裂、发育而形成胚胎的过程。	Complex 41 45 乳腺细胞
野司、直属队、南下干部再加上六纵，相当于7个旅的人马要从这里渡河，必须要在今明两天全部渡完。	Complex 30 32 渡河
城中军营里，税关局长公馆，河街上一些大字号，莫不预先截老毛竹筒，或镂空棕榈树根株，用洞硝拌和磺炭钢砂，一千槌八百槌把烟火做好。	Hard 53 54 槌
它“是一首精巧的诗”，“一首韵在骨子里的散文诗”，言有尽而意无穷。	Hard 25 32 言有尽而意无穷
在荷叶底下，石头缝里，旮旮旯旯，不知还隐藏着多少骨朵，都是在岸边难以看到的。	Hard 11 15 旮旮旯旯
至于视觉经验，也都表现得很有动感：写荷花迎风则“红披绿偃，摇荡葳蕤”，写微风拂水则“细生鳞甲”，写流萤则“（幽火）班班，若骇若惊，奄忽去来”，写山则“森森欲下搏人”。	Hard 60 64 若骇若惊
这时，戴嵩把牧童叫到跟前，和蔼地说：“小兄弟，我很愿意听到你的批评，请你说说什么地方画错了？”	Complex 3 5 戴嵩
我们终于走到草地边上，远处，重重叠叠的山峰已经看得见了。	Complex 14 18 重重叠叠
再还有‘日落江湖白，潮来天地青’：这‘白’‘青’两个字也似无理。	Hard 10 15 潮来天地青
“老人满面愁容，叹息着回答，”我，我什么也没有得到。	Complex 3 7 满面愁容
蝈蝈有着有力的大颚、锐利的钳子，不能把它的俘虏开膛破肚的情况极少出现，因为蝉没有武器反驳，只能哀鸣踢蹬。	Complex 23 27 开膛破肚
城春草木深，孟夏草木长。	Hard 0 5 城春草木深
更有殷勤的，跑回来偷拿了红薯、土豆，在火堆里煨熟给演员作夜餐，赚得进屋里有一个安全位置。	Hard 22 24 煨熟
其时进来的是一个黑瘦的老师，八字须，戴着眼镜，挟着一迭大大小小的书。	Hard 25 27 一迭
不但诗赋骈体文能有抑扬的美，散文也能有抑扬的美，不过作家们在散文中把平仄的交替运用得稍为灵活一些罢了。	Complex 9 11 抑扬
除了嘲笑那不幸的犯人的口渴之外，四周没有人出声。	Complex 2 4 嘲笑
“蘖”、“绝”、“拔”押韵，“生”、“形”押韵。	Hard 1 2 蘖
我们要铭记“滴水穿石”给予我们的启示：目标专一而不三心二意，持之以恒而不半途而废，就一定能够实现我们美好的理想。	Complex 30 34 持之以恒
每当我们读文天祥的《正气歌》“天地有正气，杂然赋流形，下则为河岳，上则为日星……”	Hard 30 32 河岳
事实上，在火山活动地区至今没有发现过斯石英。	Hard 18 21 斯石英
那泼贱贼敢来这里害我！	Complex 1 4 泼贱贼
将来，这里会是一片更茂密的松树林。	Complex 10 12 茂密
我不由地生出一种在旅游点必产生的似曾相识的无聊感。	Complex 16 20 似曾相识
手术完成之后，用相同频率的电脉冲刺激换核卵，让苏格兰黑面羊的卵细胞质与芬多席特母羊乳腺细胞的核相互协调，使这个“组装”细胞在试管里经历受精卵那样的分裂、发育而形成胚胎的过程。	Hard 36 39 多席特
乌罕娜把达丽玛送到家门前，扭身走了。	Complex 13 15 扭身
他还建立了非常美的科学的宇宙模型。	Complex 14 16 模型
有人把地毯铺在马车上，把装茶炊的箱子放在踏脚的地方。	Complex 13 15 茶炊
明屠本畯有一首诗，叙述煎荔枝的方法，说“旋沉荔花蜂酿蜜，清香不减蔗浆寒”，大概是关于荔枝蜜最早的记载。	Hard 20 27 旋沉荔花蜂酿蜜
凡此种种，都是装备在蜘蛛身上的战斗武器，而它编织的网更是它主要的武器，因此，它总是要竭尽全力，把丝网织得尽善尽美。	Complex 22 24 编织
缅伯高晓行夜宿，餐风饮露，来到陕西沔阳，离京城已经不远，见一片湖水在前，十分清澈。	Hard 17 19 沔阳
三个圆券门上方，镌刻着“民族”、“民权”、“民生”六字，室内有12根黑色花岗石圆柱，护壁为黑色大理石，左右壁上刻有中山先生的《国民政府建国大纲》全文。	Hard 8 10 镌刻
我们今天所说的远远不够表达我们内心的真实情感，言语在我们的不幸面前显得如此软弱无力：它们根本无法寄托我们对你们深深爱着的、同时也是我们所敬佩的英勇献身的人们的哀思。	Complex 79 81 哀思
像有一只巨人的手拿着明晃晃的大刀在外边想挑破那灰色的幔，像是这巨人已在咆哮发怒;越来越紧了，一闪一闪满天空瞥过那大刀的光亮，隆隆隆,幔外边来了巨人的愤怒的吼声!	Hard 26 27 幔
家乡有一句“紧走搭石慢过桥”的俗语。	Hard 6 8 紧走
在熹微的晨光里，他看见不远处有一栋小小的、红色屋顶的农家。	Hard 1 3 熹微
狐狸笑了笑，把奶酪拿过来掰成了两半。	Complex 7 9 奶酪
岸边的渔火，江心的灯标，接连地亮起，连同它们在水面映出的红色光晕，使长江像是眨着眼睛，沉沉欲睡。	Complex 43 47 沉沉欲睡
柳枝儿抱回家来，奶奶便把柳叶儿捋进盒里、筐里，然后烧一锅开水煮，煮好之后，又捞进凉水里泡。	Hard 15 16 捋
教堂钟声的加入，常常使这“免费音乐会”达到高潮。	Complex 21 23 高潮
从祖父和那长年谈话里，翠翠听明白了二老是在下游六百里外沅水中部青浪滩过端午的。	Hard 27 29 沅水
因为如果是故障，重复出现的概率并不高。	Complex 5 7 故障
它们自由得就像思想一样，东奔西跑，变化无常。	Complex 17 21 变化无常
前日我出城去，碰见了你们三房里的老四，坐着好体面车，又带着四五辆车，有四五十和尚道士儿，往家庙去了。	Hard 22 24 体面
魁梧黧黑的渔夫拖着湿淋淋的被撕破了的鱼网，一边走进来，一边说：“嘿，我回来啦，桑娜！”	Hard 0 4 魁梧黧黑
一种是“海溜”，最大，色黑，叫声洪亮。	Hard 4 6 海溜
父亲因为事忙，本已说定不送我，叫旅馆里一个熟识的茶房陪我同去。	Complex 24 26 茶房
随后就可以听到一阵喉音，以及趿拉着木皮拖鞋踏在窄狭木楼梯的踢踏声；他终于站在来客的面前，上身没有穿外衣，背有点儿弯，腰间围着皮围裙，袖子往上卷起，眼睛眨动着——像刚从靴子梦中惊醒过来，或者说，像一只在日光中受了惊动因而感到不安的猫头鹰。	Hard 14 16 趿拉
然后这个不幸的人自己要求他们将他留在睡袋里，把自己的命运和他们的命运分开来。	Complex 18 20 睡袋
是什么东西让蟋的三对脚活动起来的呢？	Hard 6 7 蟋
荷兰侵略者惊恐万状，他们利用传教士四处活动，散布谣言，说郑成功的军队要抢粮食，挑拨汉族和高山族的关系，破坏郑成功军队和台湾各族人民的团结。	Hard 14 17 传教士
的钓线一样，准确无误地向恰尔德饭店抛出一个长长的单列纵队。	Complex 6 10 准确无误
将军既帝室之胄，信义著于四海，总揽英雄，思贤如渴，若跨有荆、益，保其岩阻，西和诸戎，南抚彝、越，外结孙权，内修政理；待天下有变，则命一上将将荆州之兵以向宛洛，将军身率益州之众以出秦川，百姓有不箪食壶浆以迎将军者乎？	Hard 96 100 箪食壶浆
一种是所谓的人择原理，它可被重述如下：宇宙之所以是这种样子，是因为否则的话，我们就不会在这里观测它。	Complex 6 10 人择原理
这里有麻雀、乌鸦、鹧鸪，多着呢，夜莺倒是只有一个！	Complex 9 11 鹧鸪
3百万电子伏特的电子感应加速器，这个加速器完全有能力产生一束反电子。	Hard 30 33 反电子
余闻者甚夥，久记于心；尔后虽多用于《神鞭》、《三寸金莲》等书，仍有一些故事人物，闲置一旁，未被采纳。	Hard 3 5 甚夥
那时，我的舅父杨子敬先生每天晚饭后必给我们几个表兄妹讲一段《三国演义》，我听得津津有味，什么“宴桃园豪杰三结义，斩黄巾英雄首立功”，真是好听极了。	Complex 39 43 津津有味
请科学家们不要见笑，我以为世界之所以还有待于改进者，全因为有这些奴才的缘故。	Complex 19 22 有待于
雨中游人稀少，静谧的湖山，都由爱雨的人管领了。	Hard 19 21 管领
当公寓里的伙伴替我提了随身小提箱，领我到这房间来的时候，我瞥见这绿影，感觉到一种喜悦，便毫不犹疑地决定下来，这样了截爽直使公寓里伙计都惊奇了。	Hard 56 60 了截爽直
第二天的生意不错，可是躺了两天，他的脚脖子肿得象两条瓠子似的，再也抬不起来。	Hard 26 28 瓠子
我特意把蔓儿从竹竿的左边绕着缠上去。	Complex 4 6 蔓儿
我们平时使用的光盘，就是激光存储信息的载体。	Hard 19 21 载体
可是每逢我的病人开始盘算有多少辆马车送他出殡的时候，我就得把医药的治疗力量减去百分之五十。	Hard 20 22 出殡
大索城中；无，则之郭，之村，之山僻，之邻府州县。	Hard 1 2 索
极天云一线异色，须臾成五采。	Hard 8 10 须臾
人们可以对我们具有确定证据的那些星系和星系团中的暗物质的量作一个相当可靠的估算。	Hard 24 27 暗物质
两个虞候口里不言，肚中寻思：“这厮不值得便骂人！”	Hard 2 4 虞候
羿又伸手拔箭，准备射下最后一个太阳。	Hard 0 1 羿
他认为集邮是他一天劳累以后最好的休息方式。	Complex 3 5 集邮
后来，进剃头铺子的次数多了，才知道，剃头师傅的确最堪信赖。	Complex 4 8 剃头铺子
像鸽子笼一般地分得均匀，每边八排，每排五户，一共八十户一楼一底的房屋，每间工房的楼上楼下，平均住着三十二三个“懒虫”和“猪猡”，所以，除了“带工”老板、老板娘、他们的家族亲戚和穿拷绸衣服的同一职务的打杂、请愿警之外，这工房区域的墙圈里面住着二千左右衣服褴褛而替别人制造衣料的“猪猡”。	Hard 60 62 猪猡
我心里不由得泛起一阵同情和怜悯，大家都屏息凝神地望着他。	Complex 13 15 怜悯
带头的坐在船头上，头上缠裹着红布包头，手上拿两支小令旗，左右挥动，指挥船只的进退。	Complex 11 13 缠裹
“作善降祥”的古训，六朝人本已有些怀疑了，他们作墓志，竟会说“积善不报，终自欺人”的话。	Hard 36 40 终自欺人
我做的往往是诸葛亮、刘备一类的文角儿；只有一次我做史文恭，被花荣一箭从椅子上射倒下去，这算是我最活泼的玩艺儿了。	Hard 51 54 玩艺儿
雨来了，最轻的敲打乐敲打这城市，苍茫的屋顶，远远近近，一张张敲过去，古老的琴，那细细密密的节奏，单调里自有种柔婉与亲切，滴滴点点滴滴，似幻似真，若孩时在摇篮里，一曲耳熟的童谣摇摇欲睡，母亲吟哦鼻音与喉音。	Complex 94 96 吟哦
森林里的野猪啦，小鹿啦，兔子啦，看见狐狸大摇大摆地走过来，跟往常很不一样，都很纳闷。	Complex 20 24 大摇大摆
他们开步走，手中托着空气棗他们不敢让人瞧出他们实在什么东西也没看见。	Hard 12 13 棗
顿时，石头像雹子一样带着五位壮士的决心，带着中国人民的仇恨，向敌人头上砸去。	Complex 6 8 雹子
石榴树大盆底下也有几粒没有长成的小石榴，我很生气，问妹妹们：	Complex 0 2 石榴
船长本已不耐烦我父亲那番谈话，就冷冷地回答说：“他是个法国老流氓，去年我在美洲碰到他，就把他带回祖国。	Complex 4 7 不耐烦
当时足球被称为“鞠”。	Hard 8 9 鞠
看得多了，才注意到，作为单独的一朵太阳花，其生命却极为短促，朝开夕谢，只有一日。	Complex 30 34 朝开夕谢
这真不啻是诞生了一次。	Hard 2 4 不啻
讲到智力，在我看来，蚂蚁这家伙的确莫名所以地受到了人们的过誉。	Complex 28 30 过誉
鲁肃听了非常高兴，他对吕蒙说：“我以为你还是个大老粗呢，想不到你已经变成了学问家，真不是过去的吕蒙了！”	Hard 23 26 大老粗
宇宙就会坍缩到一个大挤压。	Complex 4 6 坍缩
前面我已经说过，它捕获到一件东西；那东西一般无论对它自己或者对别人都是毫无用处的，那东西往往比其应有的体积大六倍。	Complex 35 39 毫无用处
只见那人说道：“我自有伴当烫酒。	Hard 11 15 伴当烫酒
当飞机起飞时，下面还是黑沉沉的浓夜，上空却已游动着一线微明，它如同一条狭窄的暗红色长带，带子的上面露出一片清冷的淡蓝色晨曦，晨曦上面高悬着一颗明亮的启明星。	Hard 27 29 微明
云海汩汩地围着山头，大有海中孤岛的虚幻感。	Complex 17 19 虚幻
“昆明人家常于门头挂仙人掌一片以辟邪，仙人掌悬空倒挂，尚能存活开花。	Complex 16 18 辟邪
但不到一顿饭时候，她便回来，神气很舒畅，眼光也分外有神，高兴似的对四婶说，自己已经在土地庙捐了门槛了。	Complex 47 49 门槛
幽兰吐秀乔林下，仍自盘根众草傍。	Hard 10 12 盘根
今诸君苟不于此时植其基，勤其学，则将来万一因生计所迫，出而仕事，但任讲席，则必贻误学生；置身政界，则必贻误国家。	Hard 12 15 勤其学
小时候常听老太婆口头语：“十年难逢金满斗”，意思是盛会难逢，参加后，才知道原来这种会，只有正当金星入斗那一年才举行的。	Hard 13 20 十年难逢金满斗
皇帝手里拿着一根棍子，和地面平行，候选人员一个个依次跑上前去，有时候跳过横杆，有时候在横杆下面来回爬几遍，这完全要看横杆上升或者下降的情形而定有时候皇帝和首相各拿着木棍的一头。	Hard 77 79 首相
早饭之后，她便到镇的西头的土地庙里去求捐门槛，庙祝起初执意不允许，直到她急得流泪，才勉强答应了。	Hard 20 22 门槛
《红楼梦》是我在十二三岁时候看的，起初我对它的兴趣并不大，贾宝玉的女声女气，林黛玉的哭哭啼啼，都使我厌烦，还是到了中年以后再拿起这部书看时，才尝到“满纸荒唐言，一把辛酸泪”一个朝代和家庭的兴亡盛衰的滋味。	Hard 74 79 满纸荒唐言
你吟诵着一首首小诗，是邀我与你唱和吗？	Complex 1 3 吟诵
一个人对于自己的职业不敬，从学理方面说，便是亵读职业之神圣；从事实方面说，一定把事情做糟了，结果自己害自己。	Hard 22 24 亵读
那男人虎虎地在起得慢一点的“猪猡”身上踢了几脚，回转身来站在不满二尺阔的楼梯上面，向着楼上的另一群生物呼喊：	Hard 14 16 猪猡
这所谓灵柩，其实只是一卷用绳子捆着的芦席，说书人的脚从席子里露出来，不住随着杠手的步骤摆动，他的破长衫的一角直垂到地上，一路上扫着路上的浮土。	Complex 3 5 灵柩
我从他俨然的脸色上，又忽而疑他正以为我不早不迟，偏要在这时候来打搅他，也是一个谬种，便立刻告诉他明天要离开鲁镇，进城去，趁早放宽了他的心。	Hard 39 41 谬种
其次的话，大略是说上年解剖学试验的题目，是藤野老师讲义上做了记号，我预先知道的，所以能有这样的成绩。	Complex 11 14 解剖学
又如“信”，古代只指送信的人，现在的信古代叫“书”，《世说新语》：“俄而谢玄淮上信至，［谢安］看书竟，默默无言”，“信”和“书”的分别是很清楚的。	Hard 34 42 俄而谢玄淮上信至
老头儿说着又把刀子扎进它的脊骨和脑子中间去。	Complex 13 15 脊骨
“吹面不寒杨柳风”，不错的，像母亲的手抚摸着你。	Hard 1 8 吹面不寒杨柳风
圆圆是女生，喜欢安安静静地在一边啃竹子。	Complex 16 19 啃竹子
我给那些因为在近旁而极响的爆竹声惊醒，看见豆一般大的黄色的灯火光，接着又听得毕毕剥剥的鞭炮，是四叔家正在“祝福”了；知道已是五更将近时候。	Complex 38 42 毕毕剥剥
终于还是将那层干菜帮子全部撕光，露出了鲜嫩的、洁白的菜帮。	Hard 9 11 帮子
它的眼睛闪闪有光，并且目光十分坦率；它的耳朵也长得好，并且不大不小，不像牛耳太短，驴耳太长；它的鬣毛正好衬着它的头，装饰着它的颈部，给予它一种强劲而豪迈的模样；它那下垂而茂盛的尾巴覆盖着、并且美观地结束着它的身躯的末端：马尾和鹿、象等的短尾，驴、骆驼、犀牛等的秃尾都大不相同，它是密而长的鬃毛构成的，仿佛这些鬃毛就直接从屁股上生长出来，因为长出鬃毛的那个小肉桩子很短。	Hard 48 50 鬣毛
据后代文人考订，《清明上河图》可能作于政和至宣和年间，那正是北宋统治者在覆灭之前大造盛世假象，以此掩盖内忧外患的时期，建炎之后，南渡的北宋遗民怀念故土，在他们眼中，这副图卷必有其特殊的意义，正是他们回首故土，梦回繁华的写照。	Hard 5 7 考订
有的人不爱看张开嘴的猪，有的人瞧见一头猫就要发脾气，还有人听见人家吹风笛的声音，就忍不住要小便；因为一个人的感情完全受着喜恶的支配，谁也做不了自己的主。	Complex 63 65 支配
无论春夏秋冬，无论严寒酷暑，这里四季如春，景色怡人。	Complex 16 20 四季如春
缴租，还债，解会钱，大概能够对付过去吧；对付过去之外，大概还有多馀吧。	Complex 0 2 缴租
全体干部、战士斗志昂扬，并且提出了渡江战斗竞赛：看谁打得顽强勇猛，看谁先到对岸，看谁先占领并巩固住江边的阵地。	Complex 46 48 巩固
目光在已经走过的千里之间来回，痴想着其间在夜幕雨帐笼罩下的无数江河和高山。	Complex 21 25 夜幕雨帐
他这次不像以往那么立刻起身，观众也不像以往那样马上给他掌声，都陷入了一种回味，都浸淫了一种酸楚的离情。	Complex 48 50 离情
阿尔卑斯山的意大利人，当他们在山南坡把在山北坡得到精心保护的那同一种枞树林砍光用尽时，没有预料到，这样一来，他们就把本地区的高山畜牧业的根基毁掉了；他们更没有预料到，他们这样做，竟使山泉在一年中的大部分时间内枯竭了，同时在雨季又使更加凶猛的洪水倾泻到平原上。	Complex 122 124 倾泻
两处都是孔老夫子认为虽心向往之而力有未能的，可是叶圣陶先生却偏偏做到了。	Complex 16 20 力有未能
江理以“从者七人，二僧与俱”，组成一支浩浩荡荡的登山队，“一仆前持斧斤，剪伐丛莽，一仆鸣金继之，二三人肩糗执剑戟以随。”	Hard 36 40 剪伐丛莽
有些人，他们的姓氏我已经遗忘，他们的脸却恒常浮着——像晴空，在整个雨季中我们可能不见它，却清晰地记得它。	Complex 20 22 恒常
后来，汉朝政府在张骞走过的路上设置了四个郡，这条以长安为起点，经过河西四郡，一直通向印度、西亚乃至欧洲的交通要道——丝绸之路就畅通无阻了。	Complex 63 67 畅通无阻
我看见蜘蛛把它的腿像球样旋动，静静地躺上几小时，一直小心翼翼地注视着外界的动静，当一只苍蝇碰巧爬得够近时，它就忽然冲出洞穴，攫住它的俘获物。	Hard 62 64 攫住
倾盆大雨中，大大小小雪亮的珠子从天上撒下，在碧蓝的海水里沸腾、翻滚，它们在跳跃，它们在歌唱。	Complex 28 30 沸腾
每当我们读文天祥的《正气歌》“天地有正气，杂然赋流形，下则为河岳，上则为日星……”	Hard 21 26 杂然赋流形
头发约莫寸长，显然好久没剪了，却一根一根精神抖擞地直竖着。	Complex 2 4 约莫
水，装饰地球环境的珍珠、轻纱和彩带，无论是晶莹的水珠、雨雾云霭，还是纷纷扬扬的雪花、五彩缤纷的彩虹。	Complex 42 46 五彩缤纷
手提梢棒便走。	Hard 2 4 梢棒
我呆呆地望着来来往往吊唁的人，想到我从此永远见不到伯父的面了，听不到他的声音了，也得不到他的爱抚了，泪珠就一滴一滴地掉下来。	Hard 10 12 吊唁
我们看诗人动不动就说“秦时明月汉时关，万里长征人未还”，动不动就说“男儿何不带吴钩？	Hard 34 41 男儿何不带吴钩
我把碗端到嘴边，泪珠大颗大颗地落在热气腾腾的鱼汤里。	Complex 17 21 热气腾腾
北京时间上午9时30分，年轻的登山队员——运动健将王富洲、刘连满、屈银华和一级运动员贡布(藏族)四人，背着高山背包，扶着冰镐，开始向珠穆朗玛顶峰最后的380米高度冲击。	Hard 60 62 冰镐
于是三人乘马引从者往隆中。	Hard 6 9 引从者
二十一岁的老师解开蒙古袍衣襟，把十岁的孩子搂在身旁，在绵绵春雨中，送孩子回家。	Complex 12 14 衣襟
美猴王领一群猿猴、猕猴、马猴等，分派了君臣佐使，朝游花果山，暮宿水帘洞，合契同情，不入飞鸟之丛，不从走兽之类，独自为王，不胜欢乐。	Complex 19 23 君臣佐使
当胃的出口——幽门因病变发生阻塞时，饮食难以下通，滞留在胃部，称为幽门梗阻。	Complex 14 16 阻塞
比较早的有葡萄、苜蓿、茉莉、苹果、菠菜等等，近代的像咖啡、可可、柠檬、雪茄、巧克力、冰淇淋、白兰地、啤酒、卡片、沙发、扑克、哔叽、尼龙、法兰绒、道林纸、芭蕾舞等等，都是极常见的。	Hard 62 64 哔叽
田间与灌木篱下，横陈着田凫、椋鸟、画眉等数不清的腐鸟的血衣，鸟儿的肉已被隐秘的老饕吃净了。	Hard 39 41 老饕
视线里弥漫着黄褐色的沙地，从车轮下一直通向地球的尽头。	Complex 3 5 弥漫
领头在纤绳前后跑来跑去，见到有人没有全力以赴，竹板就打在光着的背上。	Complex 3 5 纤绳
他重重地掉在地上，光滑的壳上摔出了好多裂纹。	Complex 19 21 裂纹
不少君主重视求谏，尧设诽谤之术，舜悬招谏之鼓；封建时设立谏诤机构，付薪水养了一批谏议大夫、拾遣、补阙、正言之类的官员专挑皇帝的毛病，都是对批评稀缺的补救措施。	Complex 28 30 谏诤
那天早晨9时，在酒泉卫星发射中心，随着一声震耳欲聋的巨响，我国自行研发的“神舟五号”飞船被送上太空，火箭划过一道绚丽的曲线，看起来宛若一条蜿蜒的苍龙，瞬间便消失在苍穹之中。	Complex 33 35 研发
无智慧的书，往往材料堆积得和蚁丘一样，议论虽多，见解毫无。	Hard 14 16 蚁丘
我们都很相信这句话。	Complex 4 6 相信
罗伯特为攒钱买战斗机这事非常苦恼。	Complex 4 6 攒钱
这个唤做“智取生辰纲”。	Hard 7 10 生辰纲
以前看见包弟作揖，我就想笑，这些天我在机关学习后回家，包弟向我作揖讨东西吃，我却暗暗地流泪。	Hard 6 8 作揖
后来，黑子不再信赖它的训导员，甚至不再信赖所有的人。	Hard 11 14 训导员
至如梁、柱、枋、標、门、窗、墙、瓦、植、阶、栏杆、隔扇、斗拱、正脊、垂脊、正吻、戗兽、正房、厢房、游廊、庭院、夹道等等。	Hard 28 30 斗拱
我小心翼翼地伸出左脚去探那块岩石，而且踩到了它。	Complex 1 5 小心翼翼
其实，在约翰·肯尼迪图书馆建成的前一年———1978年，华盛顿国家艺术馆东楼的设计建造成功，便已奠定贝聿铭作为世界建筑大师的地位了。	Complex 50 53 贝聿铭
两个虞候口里不言，肚中寻思：“这厮不值得便骂人！”	Hard 15 17 这厮
六岁的小女孩柔弱的身体成了黑脸大汉手中一块生面团，翻过来、椆过去、立起来、横过去，抻、拉、压、拽，为所欲为，奶奶看不过我被整得满脸的泪水和汗水，每次都目不忍视地躲到里屋。	Hard 29 30 椆
那两边平水上的冰被当中乱冰挤破了，往岸上跑。	Complex 13 15 挤破
他能绕着地球转圈圈，在太空中释放和回收人造地球卫星。	Complex 19 25 人造地球卫星
此后又有近处的本家和亲戚来访问我。	Hard 7 9 本家
虎一般单独生活，而它所捕食的动物几乎都是群居，让人不禁质疑“团结就是力量”的概括。	Complex 27 29 质疑
开始我看得津津有味，天长日久，就感到不过瘾了。	Complex 19 21 过瘾
那是暑假里的一天，我闹着要舅舅带我去赶海，舅舅答应了。	Hard 18 20 赶海
圆圆望着篮里鲜嫩的龙眼，郑重地对妈妈说："妈妈，我要在你的挂历上写几个字。	Complex 9 11 龙眼
什么“男儿有泪不轻弹”，最是反人性的玩艺儿了。	Complex 18 21 玩艺儿
他告诉我，这索桥又叫做“何公何母桥”，是清朝初年一个姓何的教书先生设计修建的。	Hard 6 8 索桥
另外还要个拦头工人，上滩下滩时看水认容口，出事前提醒舵手躲避石头，恶浪与洑流，出事后点篙子需要准确，稳重。	Hard 42 45 点篙子
徽曰：“孔明与博陵崔州平、颍川石广元、汝南孟公威与徐元直四人为密友。	Hard 7 9 博陵
文公解释说：“雍季所说的，关系到百年大计；偃的策略，只是为了时之利，我们怎么能认为一时之利要比百年大计重要呢？”	Hard 21 22 偃
这个案子的“罪犯”呢，坐在人群中央的地上，前腿劈开，浑身发抖——原来是一条白毛的小猎狗，脸尖尖的，背上有块黄斑。	Complex 23 25 劈开
这激怒了英雄惹地豪星，决心把这个恶差除掉。	Hard 16 18 恶差
他们用两把大剪刀在空中裁了一阵子，同时用没有穿线的针缝了一通。	Hard 28 30 一通
许多同学都跟着一起背起来：“人有悲欢离合，月有阴晴圆缺，此事古难全。”	Hard 16 20 悲欢离合
父亲曾摸着其中一块的那个小凹凼惊异地说，想不到这么深了，怪不得我的烟枪已经用旧了三根呢。	Hard 12 15 小凹凼
最要留心的是别叫咱们女婿起疑心。"	Complex 10 12 女婿
一个个全部耕种过的圆圆低低的丘陵，像巨浪一般起伏着；长满灌木丛的溪谷蜿蜒在丘陵中间；一片片小小的丛林像椭圆形的岛屿一般散布着；狭窄的小径从一个村庄通到另一个村庄；教堂的墙壁呈现出白色；柳丛中间透出一条亮闪闪的小河，有四个地方筑着堤坝；远处原野中有一行野雁并列地站着；在一个小池塘上，有一所古老的地主邸宅，附有一些杂用房屋、一个果园和一个打谷场。	Complex 34 36 蜿蜒
一方的异彩，揭去了满天的睡意，唤醒了四隅的明霞——光明的神驹，在热奋地驰骋。	Hard 28 30 神驹
我们从一座楼梯顶上的天窗孔里下了屋。	Hard 10 13 天窗孔
我从敞开的窗子，看见同学们整整齐齐坐在各自的位子上，哈墨尔先生挟着那根可怕的铁戒尺走来走去。	Complex 13 17 整整齐齐
这里有五六栋没了屋顶的房子，任由风吹雨打。	Complex 16 20 风吹雨打
对于魂灵的有无，我自己是向来毫不介意的；但在此刻，怎样回答她好呢？	Complex 14 18 毫不介意
《千家诗》中很大一部分诗歌歌咏祖国风物，按春夏秋冬时序编排，打开书往下念，四季风光就活生生地展现在眼前：“成紫千红总是春”，“春城无处不飞花”；“绿树阴浓夏日长”，“五月榴花照眼明”；“青女素娥俱耐冷，月中霜里斗婵娟”；“梅雪争春未肯降，骚人搁笔费评章”……	Hard 119 126 骚人搁笔费评章
在米质好和坏的辩论之中，在斛子浅和满的争持之下，结果船埠头的敞口船真个敞口朝天了；船身浮起了好些，填没了这船那船之间的空隙的菜叶和垃圾就看不见了。	Hard 13 15 斛子
下了一夜的雨，第二天太阳出来一蒸发，草间的菌子，俯拾皆是：有的红如胭脂，青如青苔，褐如牛肝，白如蛋白，还有一种赭色的，放在水里立即变成靛蓝的颜色。	Hard 55 57 赭色
这是很可能的，因为爱因斯坦出自对人类的责任心，才签署了这封信；但是他对于武器的研究，本能地不感兴趣，推说自己不懂原子核物理，谢绝了邀请。	Complex 24 26 签署
象这样的冬天，乡下人叫作旱冬，对于麦的收成或者好些，但是人口却要受到损伤；旱得久了，白喉，流行性感冒等疾病自然容易上身，可是想恣意享受江南的冬景的人，在这一种冬天，倒只会得到快活一点，因为晴和的日子多了，去郊外去闲步逍遥的机会自然也多。	Hard 63 65 恣意
日上，正赤如丹，下有红光，动据承之。	Hard 13 17 动据承之
你们果真抱怨我，我倒欢喜；到你们的抱怨变为感谢的时候，我的悲哀来了！	Complex 17 19 抱怨
淡黑的起伏的连山，仿佛是踊跃的铁的兽脊	Complex 12 14 踊跃
那叫人柔肠寸断的杏花春雨啊，竟把炎黄子民们威武剽悍的魂魄和膂力一并溶化！	Hard 29 31 膂力
一场悲剧于焉上场。	Hard 4 6 于焉
望着他微微驼着的背脊，我心里空落落的，好像丢失了什么东西。	Complex 8 10 背脊
两个教头就在月光下一来一往，交起手来。	Hard 2 4 教头
当时居里还在世，制镭工业发展迅猛，他们夫妇俩面临着选择：第一，申请专利，巨额的经济收入可以改善实验室和家庭的生活条件；第二，放弃，无条件地把镭奉献给科学和人类。	Complex 70 71 镭
他安静地听着，当照例被问及是否有话说时，牛虻只是不耐烦地挥挥手，便把事情了结了。	Hard 20 22 牛虻
收集那些难以逐一熟记的行为举止的“道德箴言”，是不是一件轻而易举的事情呢？	Hard 19 21 箴言
后来他又发明了耒、耜，告诉人们如何耕种。	Hard 7 8 耒
其中有“松竹友朋常照映，同受雾云风雨”和“若得贡献作国香，不朽芳名留处处”的句子，用以歌颂兰花，寄托对伍若兰的情思。	Complex 48 50 寄托
走进我家的院子，你会看到坐北朝南的一排新房，房檩、房柱都是一色儿新的，散发着树脂的香味。	Hard 22 24 房檩
李白诗曰：“东风已绿瀛洲草，紫殿红楼觉春好。”	Hard 10 13 瀛洲草
突然，我觉得有人抓住了我的手腕，接着一股力把我拉出水面。	Complex 13 15 手腕
每年的5月至10月是这条河的高水位期，连续几天下了急雨，宽宽的河面上泛着油浪，水流湍急。	Hard 41 43 湍急
为了造成这样的麻醉，膜翅目猎手使用了当今先进科学可能会向实验生理学家建议的办法，即借助有毒的螫针破坏指挥运动器官的神经中枢。	Hard 57 61 神经中枢
歧江公园使我们看到了那些被熟视无睹的人们，推开了被时光默默湮没了的“单位”之门，迎面吹来清新怡和的风，听到劳动的人们在歌唱。	Complex 29 31 湮没
在平常年份，旅鼠只进行少量繁殖，使其数量稍有增长。	Complex 6 8 旅鼠
他们带利斧和美制的十字镐来，带工作灯来，人造的强光把举镐挥斧的影子投射在路面上，在公寓二楼的窗帘上，跳跃奔腾如巨无霸。	Hard 9 12 十字镐
后来，月亮姑娘再也不找人做衣裳了。	Complex 13 15 衣裳
什么个湘君，什么个湘夫人，你们的天大的本领也就只晓得痛哭几声！	Complex 3 5 湘君
两岸连山，略无阙处。	Hard 5 9 略无阙处
慢慢地，绚丽的云霞被浣净了，柔和的晚星一一就位。	Complex 10 12 浣净
永远那么纯洁，永远那么活泼，永远那么鲜明，冒，冒，冒，好像永远不感到疲乏，只有自然有这样的力量！	Complex 34 36 疲乏
穹顶呈V字形，巍峨庄观，此乃一座山门，原来我们已亲眼目睹了被称“阿尔卑斯之王”的勃朗峰。	Complex 0 2 穹顶
肚子里先有了这三个人作了底子，然后再把陶渊明、应玚，谢、阮、庾、鲍等人的一看。	Hard 23 25 应玚
比如“两岸青山相对出，孤帆一片日边来”，豪情雄壮，比如“青山一道同云雨，明月何曾是两乡”，比如“白日依山尽”，“大漠孤烟直”，“黄河之水天上来，奔流到海不复回”，比如“孤帆远影碧空尽，惟见长江天际流”，比如“无边落木萧萧下，不尽长江滚滚来”，都力量充沛得很，生命强健得很。	Hard 36 43 明月何曾是两乡
奔腾不息的黄河已流淌了150万年。	Complex 8 10 流淌
我的梦很美满，预备卒业回来，救治像我父亲似的被误的病人的疾苦，战争时候便去当军医，一面又促进了国人对于维新的信仰。	Complex 28 30 疾苦
哈尔穆拉特虽说已经四十岁了，还是个火暴性子，听了老爹的批评立即把头上戴的紫绒小花帽摘下，露出剃光了的尖而小的头。	Complex 36 38 紫绒
中华儿女无论走到哪里，无论在天之涯、海之角，都不会忘记自己的根一一故多的山，故乡的水，故乡的四合院，故乡的竹篱笆。	Complex 54 56 篱笆
嗅嗅闻闻，那冷雨。	Complex 0 4 嗅嗅闻闻
相对于中国任何一个大型国企来说，都不算大，但对中山市这样一个小城市的居民来说，曾经是一个值得自豪而令人向往的“单位”。	Complex 49 53 令人向往
渔夫一边把胆瓶挪近岸边，准备扔到海里去，一边说，“我要把你扔到海里，你说你在海里已经呆过一千八百年，这一回我非叫你在海里呆一辈子不可。	Hard 5 7 胆瓶
小白兔嚷起来：“妈妈，妈妈，我也要去！”	Complex 3 4 嚷
小二黑从小就聪明，像那些算属相、卜六壬课、念大小流年或“甲子乙丑海中金”等口诀，不几天就都弄熟了，二诸葛也常把他引在人前卖弄。	Hard 16 20 卜六壬课
而不是什么都要斤斤计较，什么都要剑拔弩张，什么都要勾心斗角，什么都要你死我活。	Complex 16 20 剑拔弩张
我们随着观潮的人流，登上海塘大堤。	Complex 12 14 海塘
那些戴旧毡帽的大清早摇船出来，到了埠头，气也不透一口，便来到柜台前面占卜他们的命运。	Complex 23 24 透
人们根据这个神话，给彩虹起了个美丽的名字，称它为“红霞瑞马”，它是壶口瀑布的一大奇景。	Hard 25 29 红霞瑞马
它能告诉人们如何备料、烹饪，还能示范如何操作和自动控制烹炒的火候。	Complex 11 13 烹饪
这个选择完全是由于我收集玩具锡兵的结果。	Complex 14 16 锡兵
摊点里陈列的木雕琳琅满目，各式各样。	Complex 8 12 琳琅满目
至于视觉经验，也都表现得很有动感：写荷花迎风则“红披绿偃，摇荡葳蕤”，写微风拂水则“细生鳞甲”，写流萤则“（幽火）班班，若骇若惊，奄忽去来”，写山则“森森欲下搏人”。	Hard 24 28 红披绿偃
胡早秋吓得要死，本能地在水中挣扎起来，搞得田立业益发艰难，一路上气喘吁吁，还喝了不少水。	Hard 24 26 益发
“青海长云暗雪山，孤城遥望玉门关。	Hard 1 8 青海长云暗雪山
布衾多年冷似铁，	Hard 0 2 布衾
幸好长孙皇后是十分贤德的女人，马上穿上吉衣朝服，说，君明则臣直，魏徵敢于顶撞陛下，说明皇上很是贤明，皇上得了直臣，故我来庆贺。	Complex 32 34 魏徵
面对违反原则的言行，不姑息放纵。	Complex 11 15 姑息放纵
爱因斯坦在两封信上都签了名，寄回给西拉德，同时提醒自己的学生，不要“过分聪明”了。	Complex 23 25 提醒
那七人道：“你这汉子忒认真！	Hard 10 11 忒
我们很费力地把口袋擒到楼下。	Hard 9 10 擒
家明还记得他六岁那年，叔公从美国洛杉矶回香港来，每次出外游玩，总带着他。	Hard 11 13 叔公
老杜有一句诗：“四更山吐月，残夜水明楼”，后代的诗人特别喜欢。	Hard 8 13 四更山吐月
经常重视对文章结构的揣摩和修改，谋篇布局的能力自然会不断提高。	Hard 10 12 揣摩
他拉着我，坐在一根伐倒的树干上，把这朵花擎在我的眼前，说：“仔细看看，仔细看看，时间已经不多了！”	Hard 20 21 擎
我再也不会走运了。	Complex 5 7 走运
大圣慌了手脚，就把金箍棒捏做绣花针，藏在耳内，摇身一变，变作个麻雀儿，飞在树梢头钉住。	Complex 40 42 钉住
老头儿又把桨翻了一个身，把刀放在鲨鱼的两颚中间，想把它的嘴撬开。	Complex 5 6 桨
到15世纪，威尼斯成为意大利最富强的“海上”共和国。	Complex 15 17 富强
那里人烟稀少的森林地带，绝大部分山岭都是悬崖绝壁，高耸入云，但也有连绵不绝的缓坡。	Complex 33 37 连绵不绝
这里我们乃可以看到“落木”一词确乎并非偶然了。	Complex 4 5 乃
这时的旅鼠不再胆小怕事，见人就跑，而是恰恰相反，在任何天敌面前它们都显得勇敢异常，无所畏惧，具有明显的挑衅性，有时甚至会主动进攻，真有点天不怕地不怕的样子。	Hard 3 5 旅鼠
塘面上有块白水，荷叶在白水边形成一条弯曲的边缘线。	Complex 21 24 边缘线
我们拾阶而上，威严的穹顶也随之愈升愈高，耸入蓝天，最后仿佛独据苍穹。	Complex 2 6 拾阶而上
似乎可以肯定地说，斯石英也应该出现在压力极高的地壳深处。	Hard 23 25 地壳
哪家出了美女，哪家的瓦板房四周，晚间便口弦声不断，清晨背水路上的脚印最多。	Hard 19 22 口弦声
铁路管理局通知说，已经没有枕木了。	Hard 13 15 枕木
箭杆上的数字表示，这一行动所需要的时间，例如15表示从把水放在炉上到水开的时间是15分钟。	Complex 0 2 箭杆
我们取道黑首，抵达高地，沿途不乏秀色美景。	Complex 2 4 取道
广袤的大地是她宽广的胸怀，茂密的森林是她飘逸的长发，温暖的太阳是她明亮的眸子，和煦的轻风是她甜蜜的絮语……	Hard 49 51 絮语
这个计划建立的“工作框架图”所提供的序列，经生物信息的加工与其他技术的研究，已鉴定了近4万个基因，而且已经克隆了几十种与疾病直接有关的“疾病等位基因”。	Hard 68 74 疾病等位基因
大约具有太阳质量的恒星不是变成白矮星就是变成中子星〔中子星〕恒星在核能耗尽后，经过引力坍缩，依靠简并中子的压力与引力平衡形成的星体。	Hard 43 45 坍缩
“后之视今，亦犹今之视昔”，你们不久也要走这条路呢！	Hard 11 12 昔
爸爸非常珍惜每一次下海的机会。	Complex 9 11 下海
至于我的喊声是勇猛或是悲哀，是可憎或是可笑，那倒是不暇顾及的；但既然是呐喊，则当然须听将令的了，以我往往不恤用了曲笔，在《药》的瑜儿的坟上平空添上一个花环，在《明天》里也不叙单四嫂子竟没有做到看见儿子的梦，因为那时的主将是不主张消极的。	Complex 35 37 呐喊
有一天，我在我家八字门口和一班孩子“掷铜钱”，一位老辈走过，见了我，笑道：“穈先生也掷铜钱吗？”	Hard 38 39 穈
蓝天瘦的时候，云就多些，是白底蓝花的青花瓷器，是明代官窑的极品；蓝天胖的时候，云就少些，是蓝底白花布，那是黔贵山区民间的手工蜡染粗布。	Complex 53 57 黔贵山区
为了人类能够生活在一个“和而不同”的世界上，从现在起就必须提倡在审美的、人文的层次上，在人们的社会活动中树立起一个“美美与共”的文化心态，这是人们思想观念上的一场深刻大变革，它可能与当前世界上很多人习惯的思维模式和行为方式相抵触。	Complex 112 114 抵触
夜来风雨声，花落知多少？	Hard 0 5 夜来风雨声
妖魔鬼怪们听说森林王国的树木都砍光了,高兴得手舞足蹈,一个个跃跃欲试,要去那里逞逞威风。	Complex 39 43 逞逞威风
随着祖国社会主义建设事业的发展，1974年又建成了黄河上唯一的单孔铁路桥和宽十米、长一百四十米、钢筋混凝土结构的悬索公路吊桥。	Hard 50 53 混凝土
事实上，我的乐趣是丰富多彩的。	Complex 9 13 丰富多彩
把一幅广为人知的标语送给他们，因为他们值得让人们骄傲：“再苦不能苦孩子，再穷不能穷教育。”	Complex 3 7 广为人知
就这样，鷸和蚌相持着，谁也不让谁。	Hard 4 5 鷸
哦，一个女子，我想：月亮里，地该是银铺的，墙该是玉砌的，那么好个地方，配住的一定是十分漂亮的女子了。	Complex 24 26 玉砌
她们躺的地方，到了一定的时间是非让出来做吃粥的地方不可的，可是在那一天，芦柴棒可真的挣扎不起来了，她很见机地将身体慢慢地移到屋子的角上，缩做一团，尽可能地不占地方。	Hard 51 53 见机
小羊也说：“大象啊，你的耳朵怎么是耷拉着的呢？”	Hard 17 19 耷拉
两地纬度相差无几，因为烟台靠海，春天便来得迟了。	Hard 2 8 纬度相差无几
目前已知最大的鲸约有十六万公斤重，最小的也有两千公斤。	Complex 7 8 鲸
她松松地皱缬着，像少妇拖着的裙幅；她轻轻地摆弄着，像跳动的初恋的处女的心；她滑滑地明亮着，像涂了“明油”一般，有鸡蛋清那样软，那样嫩，令人想着所曾触过的最嫩的皮肤；她又不杂些儿尘滓，宛然一块温润的碧玉，只清清的一色——但你却看不透她！	Hard 4 6 皱缬
中国有句古话：“敬业乐群。”	Hard 8 12 敬业乐群
“进士致身卿相为社会心理群趋之鹄的”，这跟科举考试有很大的关系，即汉魏以来中国古代知识人的地位大幅度上升有很大的关系，跟唐代的国力有很大的关系，这是中国文化的复兴之象。	Hard 12 17 群趋之鹄的
而硬币打制器的功能则是在金币之类的小平面上打出印花来。	Complex 3 5 打制
在我进院的第二天，早起刚开了门，它已从门隙钻进来，一跃到我床上，悄悄地便伏在我的怀前，眼睛慢慢地闭上，很安稳地便要睡着。	Complex 19 21 门隙
对于每一次这样的胜利，自然界都对我们进行报复。	Complex 20 22 报复
我若能裁你以为带，我将赠给那轻盈的舞女，她必能临风飘举了。	Hard 2 4 能裁
荷塘四面，长着许多树，蓊蓊郁郁的。	Hard 11 15 蓊蓊郁郁
这时候我已挨了将近十个钟头的冷雨，全身没有一处不瑟瑟发抖。	Complex 5 6 挨
又枕帕头巾边沿用茉莉花苞作装饰的，比用小三角锯齿纹（通称狗牙齿）时代早些，狗牙齿边盛行于晚清，茉莉花流行于同光时，至于四合如意规矩格子花，则是二百年前式样。	Hard 59 63 四合如意
回家的路上，我就戴着花脸，倚着舅舅执刀而立，一路引来不少人瞧我。	Hard 10 12 花脸
临窗大炕上铺着猩红洋罽，正面设着大红金钱蟒靠背，石青金钱蟒引枕，秋香色金钱蟒大条褥。	Hard 9 11 洋罽
你爸爸和你们一样大的时候，这里水獭很多。	Complex 15 17 水獭
孩子们用龙眼核给他做眼珠，又从谁的母亲的脂粉奁中偷得胭脂来涂在嘴唇上。	Hard 20 23 脂粉奁
在克隆鲫鱼出现之前，英国牛津大学的科学家已经在1960年和1962年，先后用非洲一种有爪的蟾蜍(非洲爪蟾)进行过克隆试验。	Hard 45 47 蟾蜍
例如《诗经·鲁颂》的《駉》这一首诗里提到马的名称就有16种：“驈”(身子黑而胯下白的)，“皇”(黄白相间的)，“骊”(纯黑色的)，“黄”(黄而杂红的)，“骓”(青白杂的)，“駓”(黄白杂的)，“騂”(红黄色的)，“骐”(青黑成纹像棋道的)，“驒”(青黑色而有斑像鱼鳞的)，“骆”(白马黑鬃)，“駵”(红马黑鬃)，“雒”(黑马白鬃)，“駰”(灰色有杂毛的)，“騢”(红白杂毛的)，“驔”(小腿长白毛的)，“鱼”(两眼旁边毛色白的)。	Hard 11 12 駉
“后之视今，亦犹今之视昔”，你们不久也要走这条路呢！	Hard 1 4 后之视
她松松地皱缬着，像少妇拖着的裙幅，她轻轻地摆弄着，像跳动的初恋的处女的心:她滑滑地明亮着，像涂了“明油”一般，有鸡蛋清那样软，那样嫩，令人想着所曾触过的最嫩的皮肤，她又不杂些儿尘滓，宛然一块温润的碧玉，只清清的一色————但你却看不透她！	Hard 4 6 皱缬
他回到我母亲身旁，是那么神色张皇。	Complex 12 16 神色张皇
这时船慢了，不久就到，果然近不得台旁，大家只能下了篙，比那正对戏台的神棚还要远。	Hard 25 26 篙
于是，她又找啊找啊，终于在一眼清清的泉水中找到了。	Complex 13 15 一眼
母亲说：“还早呢，没开足，摇不下来的。”	Hard 10 12 开足
例如《诗经·鲁颂》的《駉》这一首诗里提到马的名称就有16种：“驈”(身子黑而胯下白的)，“皇”(黄白相间的)，“骊”(纯黑色的)，“黄”(黄而杂红的)，“骓”(青白杂的)，“駓”(黄白杂的)，“騂”(红黄色的)，“骐”(青黑成纹像棋道的)，“驒”(青黑色而有斑像鱼鳞的)，“骆”(白马黑鬃)，“駵”(红马黑鬃)，“雒”(黑马白鬃)，“駰”(灰色有杂毛的)，“騢”(红白杂毛的)，“驔”(小腿长白毛的)，“鱼”(两眼旁边毛色白的)。	Hard 167 168 駰
它的成就，真可说是“包罗万有，丰富多彩。”	Complex 10 14 包罗万有
爸爸精通四种外语，所以能胜任联合国复杂的维和工作，这给雷棣极深的印象。	Complex 20 22 维和
飞了千里万里路，凤凰落在梧桐树。	Complex 8 10 凤凰
相比之下，钱文最后十六字里日既出的景色，就平淡简单，逊色许多。	Complex 14 16 既出
这时，普鲁士军队操练回来的军号声在我们窗前响了起来……	Complex 8 10 操练
这一天，哈墨尔先生特别为我们准备了崭新的字模，上面用漂亮的花体字写着：“法兰西，阿尔萨斯，法兰西，阿尔萨斯。”	Hard 4 7 哈墨尔
疑问是这样的：刚刚从人工孵卵器孵出的小雁鹅，总是把第一个碰到的生物认作是自己的母亲，并且一心一意地跟随着她；但是水鸭子就不同了，凡是由人工孵卵器养出的小凫，总是极其羞怯，难以接近，每次一出壳，就赶紧逃开，躲到附近的暗角里不肯出来。	Hard 19 21 雁鹅
他管这种枕头叫“警枕”。	Hard 8 10 警枕
特别值得一提的是那些笔、墨水、纸，船主、大副、炮手和木匠的几包东西，三四个罗盘，一些数学仪器，日晷、望远镜、地图、航海书籍之类。	Complex 20 22 大副
它不同于：“美女妖且闲，采桑歧路间；柔条纷冉冉，落叶何翩翩。”	Hard 6 11 美女妖且闲
（四）斗拱：在一副梁架上，在立柱和横梁交接处，在柱头上加上一层层逐新挑出的称做“拱”的号形短木，两层拱之间用称做“斗”的斗形方木块垫着。	Hard 3 5 斗拱
首先，我购买了少量的钠22，它是一种能够自然地放射正电子（电子的反物质）的放射性物质。	Hard 32 35 反物质
沙丘一步步向城市逼近,百姓只好背井离乡、四处逃荒。	Complex 22 24 逃荒
鲁迅在自然景物描写中寄托了自己的爱增感情，向往江南雪景温暖的春天一般的美好理想，而增恶把期方的雪花变成孤独和冰冷的严酷的冬天，就是鲁迅在这篇散文诗中所寄寓的曲深的情怀。	Complex 16 20 爱增感情
这时水稻扬花了，馥郁的稻香沁人心脾，袁隆平的心沉浸在无边无际的稻海之中。	Complex 26 30 无边无际
特别值得一提的是那些笔、墨水、纸，船主、大副、炮手和木匠的几包东西，三四个罗盘，一些数学仪器，日晷、望远镜、地图、航海书籍之类。	Hard 47 49 日晷
他感觉到手里提的灯晃来晃去。	Complex 9 13 晃来晃去
狂风大作的时候我在温暖的室内，却不会想到风是如何污辱我和我的树苗的——它把我的树从窗台上抱起来，砸在河边石埠上，然后又把树苗从花盆里拖出来，推向河水里，将一只破碎的花盆和一抔泥土留在岸上，留给我。	Hard 52 54 石埠
而旋风中的雪景的壮观，作家只用这样几个简洁的短句描绘：“旋风忽来，便蓬勃地奋飞，在日光中灿灿地生光，如包藏火焰的大雾，旋转而且升腾，弥漫太空”——寥寥数语，那旷野上闪闪地旋转升腾的壮丽的雪景已如在读者眼前。	Complex 66 68 弥漫
《诗·召南·草虫》说：“喓喓草虫，趯趯阜螽。”	Hard 17 21 趯趯阜螽
它好像听懂了我的话，撒娇似的的吮着我的大拇指，用头蹭着我的膝盖，鼻子里发出轻轻的哼声。	Hard 15 16 吮
1929年2月12日，伍若兰在赣州英勇就义。	Hard 15 17 赣州
科学技术的进步是一柄双刃剑，诺贝尔发明的硝化甘油炸药用于采矿、修路等方面，提高了人类改造自然的能力，但它也为制造杀伤力更大的炮弹提供了条件。	Complex 10 13 双刃剑
这位身材高大、精神矍铄的老人，此刻面容极其凝重。	Hard 7 11 精神矍铄
但他知道明朝大势已去，就召集手下众将，说：“吾誓以身殉城！”	Hard 23 28 誓以身殉城
这闭着的眼睛便看见一切圆满，当前的苦痛不过是“天之将降大任于是人也，必先苦其心志，劳其筋骨，饿其体肤，空乏其身，行拂乱其为”。	Hard 56 61 行拂乱其为
为了造成这样的麻醉，膜翅目猎手使用了当今先进科学可能会向实验生理学家建议的办法，即借助有毒的螫针破坏指挥运动器官的神经中枢。	Complex 10 13 膜翅目
当天傍晚，毛主席率领全体政协委员为纪念碑举行了庄严隆重的奠基礼，毛主席亲自执锨铲土，为纪念碑奠定基石。	Hard 28 31 奠基礼
各类店铺经营着罗锦布匹、沉檀香料、香烛纸马，另有医药门诊、大车修理、看相算命、修面整容，应有尽有。	Complex 7 9 罗锦
由于另一条鲨鱼正在蹂躏死鱼的缘故，船身还在晃荡，老头儿松开了帆脚绳，让船向一边摆动，使鲨鱼从船底下出来。	Complex 30 33 帆脚绳
她递给我一株野菊花，花边已经打卷了，花朵耷拉下来。	Complex 14 16 打卷
如果赶上这么一场用以耀武扬威的乱子，你就甭想有鱼咬钩了。	Complex 10 14 耀武扬威
是的，这好像是废话，卑之无甚高论。	Hard 12 16 无甚高论
公爵大家让开些，让他站在我的面前。	Hard 0 2 公爵
玄德曰：“且勿惊动。”	Hard 5 9 且勿惊动
王冕不禁看得入了迷，心里想道：“古人说‘人在图画中’，真是一点不错。	Complex 0 2 王冕
肚子里先有了这三个人作了底子，然后再把陶渊明、应玚，谢、阮、庾、鲍等人的一看。	Hard 32 34 鲍等
黄翅飞蝗泥蜂在杀死蟋蟀时无疑是使出了最高明的手段的，所以有必要看看它是怎样杀死猎物的。	Hard 2 6 飞蝗泥蜂
“天行健，君子以自强不息；地势坤，君子以厚德载物。”	Hard 13 16 地势坤
刘伯承狠狠地教训了他一顿后，给他解开脚上的套绳，叫他向在场的细娃作揖赔礼后，才命令他滚蛋。	Hard 30 32 细娃
这声音穿过茫茫太空，传到北京指挥控制中心，传到游弋在浩瀚大洋上的“远望”3号测量船，传到每一个炎黄子孙的心中。	Hard 23 25 游弋
我们只是说，在传统思想中，广泛流传而又具有推动文化发展的积极作用的，是《周易大传》的“自强不息”“厚德载物”的精湛思想。	Complex 49 53 厚德载物
原来，这是两百多年前，引自锡兰国（今名斯里兰卡）的两棵菩提树。	Complex 27 30 菩提树
若天空有云，你会看见灿烂的晚霞；全天无云，不要忘记回头，你会发现背后的天空中现出神秘的蓝灰色暗弧，暗弧外面还镶有明显的亮弧。	Complex 54 55 镶
田间与灌木篱下，横陈着田凫、椋鸟、画眉等数不清的腐鸟的血衣，鸟儿的肉已被隐秘的老饕吃净了。	Hard 14 16 椋鸟
地下两溜十六张楠木交椅，又有一副对联，乃乌木联牌，镶着錾银的字迹，道是：	Hard 22 24 联牌
尽管有时候，我会热泪盈眶，但与爸爸交谈感觉真好，和他在一起很舒服，流泪之后人也感觉好得多。	Complex 8 12 热泪盈眶
我家的厨师是一个足智多谋的人，除了调和鼎鼐之外还贯通不少的左道旁门，他因为厨房里的肉常常被猫拖拉到灶下，鱼常被猫叼着上了墙头，怀恨于心，于是殚智竭力，发明了一个简单而有效的捕猫方法。	Hard 17 21 调和鼎鼐
老人摇摇头说：“这不过是无心插柳柳成荫。”	Hard 12 19 无心插柳柳成荫
沙山的斜坡很是舒缓，牛毛般光泽细软，而线条清晰有如刀刃般的山脊无论直线还是弧度，都高贵得不可企及。	Complex 7 9 舒缓
蝈蝈有着有力的大颚、锐利的钳子，不能把它的俘虏开膛破肚的情况极少出现，因为蝉没有武器反驳，只能哀鸣踢蹬。	Hard 7 9 大颚
这里包含的诗人的感情，是对寒冷环境的反抗，也是对不屈的、斗争的品格的歌颂，有荷戟独彷徨的孤寂之感，也有永不停息战斗的低强精神。	Complex 34 36 歌颂
糟糕的是，在天敌的保护作用消失以前，我们总是对其知之甚少。	Complex 6 8 天敌
我的眼睛里蒙上了雾，我也全身打战，两手发抖……	Complex 14 16 打战
听完了居里的陈述以后，居里夫人毫不犹像地说：“我们不能申请专利，这是违反科学精神的。”	Complex 29 31 专利
一种极大，头胸浓绿色，腹部有黑色的环纹，尾部两侧有革质的小圆片，叫做“绿豆纲。”	Hard 25 27 革质
掌柜说，“哦！”	Complex 0 2 掌柜
一个肩膀宽宽的小伙，肩上垫了一块老蓝布，扛了几枝青竹，竹梢长长的拖在他后面，刮打得石级哗哗作响。……	Complex 2 4 肩膀
但我知道，总有一天他必须独立面对疾病。	Complex 16 18 疾病
我说它像勒勒车的轮子，只是一个顺手攫来的想法，它当然较这轮子要大得多。	Hard 17 19 攫来
黄河及其支流泛滥过后，造就了大面积肥沃的土地，特别适合种植粟黍一类旱地作物；可是泛滥的河水，时常给人畜带来灾害。	Hard 29 31 粟黍
比如“两岸青山相对出，孤帆一片日边来”，豪情雄壮，比如“青山一道同云雨，明月何曾是两乡”，比如“白日依山尽”，“大漠孤烟直”，“黄河之水天上来，奔流到海不复回”，比如“孤帆远影碧空尽，惟见长江天际流”，比如“无边落木萧萧下，不尽长江滚滚来”，都力量充沛得很，生命强健得很。	Complex 131 133 强健
天也晚了，不虚留你们了。	Hard 6 8 虚留
周瑞家的命雇的小丫头倒上茶来吃着。	Hard 5 6 雇
他们像抚养婴儿似的照看着这个小瓜，浇水，施肥，一点也不敢马虎。	Complex 3 5 抚养
地呼唤着，足足飞行了三个小时，才冲出了北冰洋的风雪圈。	Complex 1 3 呼唤
沅州上游不远有个白燕溪，小溪谷里生芷草，到如今还随处可见。	Complex 24 28 随处可见
《红楼梦》第四十九回里就有这样一段：“黛玉换上掐金挖云红香羊皮小靴，罩了一件大红羽绉面白狐皮的鹤氅，系一条青金闪绿双环四合如意绦，上罩了雪帽。”	Hard 31 33 小靴
一阵窸窸窣窣的声音，每个人都拿出讲义，端端正正摆在面前。	Hard 2 6 窸窸窣窣
它们从来不发生追捕一只小兽或向同类劫夺一点东西的事件，而这类事件正是其他食肉类动物通常互争互斗的根源：所以马总是和平生活着的，其原因就是它们的欲望既平凡又简单，而且有足够的生活资源使它们无需互相妒忌。	Complex 17 19 劫夺
半夜里，听见一声震天动地的巨响，大山崩塌了，地下涌出洪水，把他们住的村子淹没了。	Complex 36 38 淹没
例如《诗经·鲁颂》的《駉》这一首诗里提到马的名称就有16种：“驈”(身子黑而胯下白的)，“皇”(黄白相间的)，“骊”(纯黑色的)，“黄”(黄而杂红的)，“骓”(青白杂的)，“駓”(黄白杂的)，“騂”(红黄色的)，“骐”(青黑成纹像棋道的)，“驒”(青黑色而有斑像鱼鳞的)，“骆”(白马黑鬃)，“駵”(红马黑鬃)，“雒”(黑马白鬃)，“駰”(灰色有杂毛的)，“騢”(红白杂毛的)，“驔”(小腿长白毛的)，“鱼”(两眼旁边毛色白的)。	Hard 87 88 駓
于是他们就把这些色彩和稀有的花纹描述了一番，还加上些名词。	Complex 11 13 稀有
外交事务和防务，香港特别行政区依据基本法享有行政管理权、立法权、独立的司法权和终审权。	Complex 5 7 防务
这种苦痛却比不得普通的贫、病、老，可以达观排解得开。	Hard 19 23 达观排解
看样子，劲头比上树的时候足多了。	Complex 4 6 劲头
经过郊区，我闻到刺鼻的化学品烯燃烧的气味，湾里的小商人焚烧电缆。	Hard 14 15 烯
二十六个春秋过去，象鞍已经破旧了，仍显出凝重华贵；嘎羧披挂上象鞍，平添了一股英武豪迈的气概。	Hard 25 27 嘎羧
它的社论是有名的，我在中学时，老师经常选来给我们当课文讲。	Hard 2 4 社论
李小二道：“官人请甚客？”	Hard 6 8 官人
街上突然加多了人，铺子里的人争着往外跑，都攥着把蒲扇遮着头，四下里找。	Hard 21 22 攥
在此顺便说一句，我酷爱古典诗词，但能够从头背到底的，只有岳武穆的《满江红》“怒发冲冠”那一首，还有就是李易安的《声声慢》，她那几个叠字：“寻寻觅觅冷冷清清，凄凄惨惨戚戚……”	Hard 69 77 寻寻觅觅冷冷清清
而淮南小山的《招隐士》里又说：“桂树丛生兮山之幽。”	Hard 18 20 丛生
如果不是因为我出了名的无害于人，大概老早就给关进疯人院了，等我说过一个小故事之后，你就明白为什么艾顿堡的居民都把我当疯子了。	Complex 11 15 无害于人
江理以“从者七人，二僧与俱”，组成一支浩浩荡荡的登山队，“一仆前持斧斤，剪伐丛莽，一仆鸣金继之，二三人肩糗执剑戟以随。”	Hard 9 13 二僧与俱
物候现象的来临决定于哪些因素呢？	Hard 0 4 物候现象
鲁迅先生走路很轻捷，尤其使人记得清楚的，是他刚抓起帽子来往头上一扣，同时左腿就伸出去了，仿佛不顾一切地走去。	Complex 7 9 轻捷
小刺猬也高兴极了，说：“谢谢你，你的称赞消除了我一天的疲劳！”	Complex 1 3 刺猬
险绝处的红漆栏杆，本身便是可美的风景。	Hard 0 3 险绝处
从那以后，一队队骆驼商队在这漫长的商贸大道上行进，他们越过崇山峻岭，将中国的养蚕、缫丝、冶铁、造纸、凿井、灌溉等技术带向中亚、西亚和欧洲，将那里的葡萄、核桃、石榴、蚕豆、黄瓜、芝麻、无花果等食品带到我国，还有狮子、犀牛、良马等动物，也传进了我国。	Hard 41 43 缫丝
《红楼梦》是我在十二三岁时候看的，起初我对它的兴趣并不大，贾宝玉的女声女气，林黛玉的哭哭啼啼，都使我厌烦，还是到了中年以后再拿起这部书看时，才尝到“满纸荒唐言，一把辛酸泪”一个朝代和家庭的兴亡盛衰的滋味。	Complex 42 46 哭哭啼啼
周总理一手端着盛满清水的银碗，一手拿着柏树枝蘸了水，向人们泼洒，为人们祝福。	Hard 22 23 蘸
大概因为作品和别的先生的介绍，我侥幸认识了巴黎音乐院的大作曲家普罗·刁客先生，他是世界三大音乐家之ー（印象派）。	Complex 16 18 侥幸
有时，我特别愿意静静地站在图书馆阅览室的门口，看那些伏案读书者专注而入迷的神情;也愿意一边走向第三教学楼，一边听身旁经过的人高声争论着什么问题，——吸引我的，往往不是他们争辩的题目，而是北大人特有的敏感，学生特有的纯洁，言谈的犀利与机智，精神状态的生机勃勃;更愿意站在广告栏前，一张一张细细地读那些五颜六色的海报，为的是永不厌倦地重温北大清新自由的气氛。	Complex 113 115 犀利
靠近金门大桥则有一处观海鸟的胜地，太平洋海湾中有三个小岩石孤岛，栖息着上万只大嘴鹈鹕、鱼鹰、海鸥。	Hard 40 42 鹈鹕
然而，水流这时已经很急，转眼间涨到近半米，吉普车没能如愿冲到圩堤前就熄了火，二人只好弃车徒步往堤上奔。	Hard 30 32 圩堤
这时，数十只幼龟已成了嘲鸫、海鸥、铿鸟的口中之食，我们的向导摘下头上的棒球帽，迅速抓起十数只幼龟，放进帽中，向海边奔去。	Hard 17 19 铿鸟
前面还有一两个更紧迫的问题。	Complex 8 10 紧迫
费了很大工夫找来了一个律师，拟定了附属证书。	Hard 17 21 附属证书
因这年秋尽冬初，天气冷将上来，家中冬事未办，狗儿未免心中烦躁，吃了几杯闷酒，在家里闲寻气恼，刘氏不敢顶撞。	Hard 10 14 冷将上来
当日林如海教女以惜福养身，云饭后务待饭粒咽尽，过一时再吃茶，方不脾胃。	Hard 20 22 咽尽
我是个沧海曾经的人，对于海却总是漠然地，这或者是因为我会晕船的缘故罢！	Hard 3 7 沧海曾经
女教师特别喜欢娜塔娅，因为娜塔娅天天会给她带去希望和快乐。	Complex 7 10 娜塔娅
将军翻身下马，立正高呼：“本将军奉命率官兵欢迎大汉国使者！”	Complex 16 18 奉命
这是一头健壮结实的奶牛，曾经有过所有奶牛都有过的生活经历，它产下了小犊，然而连看它们一眼舔它们一下都没有来得及便被人带走了，这以后便吃着粗粝的草料，心甘情愿地把牛奶奉献出来。	Complex 68 70 粗粝
“男爵爱卿，”他厉声言道，“朕想卿也明白，‘陛下’这个称呼在全国范围内只属于孤家一人，再没有旁人称得起‘陛下’了！	Hard 38 40 孤家
这条发展的途径，中国建筑和欧洲希腊、罗马的古典建筑体系，乃至埃及和两河流域④的建筑体系是完全一样的，所不同者，是那些体系很早就含弃了木材而完全代以砖石为主要材料。	Complex 41 43 体系
雨来急出一身冷汗。	Complex 0 2 雨来
这一天，哈墨尔先生特别为我们准备了崭新的字模，上面用漂亮的花体字写着：“法兰西，阿尔萨斯，法兰西，阿尔萨斯。”	Hard 20 22 字模
孔子亦说：“君子和而不同。”	Hard 8 12 和而不同
经过25年的猎捕，有数千只狼先后毙命。	Complex 16 18 毙命
没有狰狞的旋风、没有虚幻的海市、没有稍纵即逝的彩虹，却有冒着炊烟的房屋、欢乐的人群、油绿的青稞麦和丰收的田野……	Complex 30 32 炊烟
这个人打扮与众姑娘不同，彩绣辉煌，恍若神妃仙子：头上戴着金丝八宝攒珠髻，绾着朝阳五凤挂珠钗；项下戴着赤金盘螭璎珞圈；裙边系着豆绿宫绦双鱼比目玫瑰佩；身上穿着缕金百蝶穿花大红洋缎窄裉袄，外罩五彩刻丝石青银鼠褂，下罩翡翠撒花洋绉裙。	Hard 52 57 盘螭璎珞圈
少焉，月出寒阴，微明散布石上，松声倏然自万壑来，客皆悚视寂，觉境愈清，思愈远。	Hard 24 29 客皆悚视寂
我将看见所有的人们在我面前低头，鞠躬，匍匐，连同我的尊长，我的师友，和从前曾在我面前昂头阔步、耀武扬威的人们。	Complex 16 18 鞠躬
酒保唱了喏，认得是鲁提辖，便道：“提辖官人，打多少酒？”	Hard 4 5 喏
手术完成之后，用相同频率的电脉冲刺激换核卵，让苏格兰黑面羊的卵细胞质与芬多席特母羊乳腺细胞的核相互协调，使这个“组装”细胞在试管里经历受精卵那样的分裂、发育而形成胚胎的过程。	Hard 19 21 核卵
我正在左右搜寻,立明对我努劝嘴——只见不远处站着一个穿夹克衫的壮汉,一脸木然,好像根本不知道发生的事。	Hard 12 15 努劝嘴
他摇了摇头，“因为这些行为如此稀奇古怿，以致人们连可能的假说也提不出来。”	Complex 15 19 稀奇古怿
雪峰上冰川悬垂，云雾缭绕，气象万千。	Complex 5 7 悬垂
有弗学，学之弗能弗措也；有弗问，问之弗知弗措也；有弗思，思之弗得弗措也；有弗辨，辨之弗明弗措也；有弗行，行之弗笃弗措也。	Hard 4 11 学之弗能弗措也
这时，他的同伴突然醒来，开始大声咳嗽，痰卡在嗓子里。	Complex 22 24 嗓子
玄德屏人促席而告曰：“汉室倾颓，奸臣窃命，备不量力，欲伸大义于天下，而智术浅短，迄无所就。	Hard 0 3 玄德屏
在山冈小径上，我看到一只蚂蚁在拖蜣螂的尸体。	Hard 16 18 蜣螂
司机说，你们的运气不错呵，戈壁滩上的旋风、海市、彩虹、丝路花雨，都看见了。	Hard 27 31 丝路花雨
假如你不喜欢它，漫长的70000个小时，足以让花容磨损日月无光，每一天都如同穿着淋湿的衬衣，针芒在身。	Complex 46 50 针芒在身
这思绪如同一片白云，飘浮在我心灵的天空上，使之变得宁静而高远……	Complex 28 30 高远
阴房修在山坡上，样子很像碉堡，四周留着许多小孔，里面钉着许多木架子。	Hard 0 2 阴房
大大小小几何形的麦田将原野均匀分割，种粒的全部能量转化为垄间破土而出的禾苗，它们将在秋天成熟，连绵不绝，设下朴素的宴席——握住镰柄的农民融入麦芒闪耀的金光里，积年劳作使他们的掌心磨砺出粗厚的老趼。	Complex 30 34 破土而出
有弗学，学之弗能弗措也；有弗问，问之弗知弗措也；有弗思，思之弗得弗措也；有弗辨，辨之弗明弗措也；有弗行，行之弗笃弗措也。	Hard 52 59 行之弗笃弗措也
涂色料的工作既然叫点蓝，不用说，烧的工作当然叫烧蓝。	Complex 9 11 点蓝
然而，在另一篇题为《从生物学的角度向米老鼠致敬》中，古尔德却又对“粗略的大小和外在的形状”，也就是这方面的数字，发生了极大的兴趣，而且用它们来捍卫自己的幼态持续学说。	Hard 76 78 幼态
即使这儿只是上游，还没有具有一泻千里的规模，但它那万马奔腾、浊浪排空的气概，足以使人胆惊心悸。	Complex 30 34 浊浪排空
翻开一部《辞源》或《辞海》，金木水火土，各成世界，而一入“雨”部，古神州的天颜千变万化，便悉在望中，美丽的霜雪云霞，骇人的雷电霹雹，展露的无非是神的好脾气与坏脾气，气象台百读不厌门外汉百思不解的百科全书。	Complex 45 49 悉在望中
这一发现之所以震惊世界，是因为它出土的不是像埃及、希腊、意大利出土的那种单个的艺术精品，而是气势宏伟、规模巨大、结构严整，让世人震撼的艺术精品群体。	Complex 64 66 震撼
小洁紧紧攥着面包纸，生怕它掉进湖里。	Hard 4 6 攥着
他喜欢剧烈运动，那时流传着关于他如何强悍的种种佳话。	Complex 18 20 强悍
扁鹊解释道：“皮肤病用热水敷烫就能够治好；发展到皮肉之间，用扎针的方法可以治好；即使发展到肠胃里，服几剂汤药也还能治好；一旦深入骨髓，只能等死，医生再也无能为力了。	Complex 76 80 无能为力
我们可以看见它们身上的每一根毫毛。	Complex 14 16 毫毛
他和妈妈把爸爸的骨灰盒请回来，放在爸爸生前读书的写字台上，那顶象征和平的蓝盔搁置其上。	Complex 38 40 搁置
被子植物的花有了花被，更分化为萼和花冠。	Hard 15 16 萼
静候一旁的考察队员按捺住激动的心情,像守候着一只易碎的宝瓶一样,小心翼翼地观察着,悄悄地拍摄照片,生怕惊飞了这两只珍稀的鸟儿。	Complex 32 36 小心翼翼
他和全民族都遭受日本侵略带来的痛苦，而他的妻子林微因的弟弟，作为一名中国军队的飞机驾驶员，就牺性于对日空战之中。	Complex 46 48 牺性
将军既帝室之胄，信义著于四海，总揽英雄，思贤如渴，若跨有荆、益，保其岩阻，西和诸戎，南抚彝、越，外结孙权，内修政理；待天下有变，则命一上将将荆州之兵以向宛洛，将军身率益州之众以出秦川，百姓有不箪食壶浆以迎将军者乎？	Hard 32 36 保其岩阻
那只宠鹰已不在他的手腕上，它在前面飞行，它认得回家的路。	Complex 2 4 宠鹰
宝玉听了，登时发作起痴狂病来，摘下那玉，就狠命摔去，骂道：“什么罕物，连人之高低不择，还说‘通灵’不‘通灵’呢！	Hard 41 42 择
教师照例引一段范文，当大多数同学千篇一律地开始写“秋天来了，树叶黄了，一片一片地飘到了地上”时，我忽然掠过了不安分的一念：大家都这样写多没意思！	Complex 51 53 掠过
他勉强一笑，说：“我一直在数你的刀数。”	Complex 1 3 勉强
它被一个小鹅卵石挡住了路，它不是绕过了它，而是倒退着向上登，把它的捕获物跟着往上拽，在小鹅卵石的另一面翻滚了下去。	Complex 5 8 鹅卵石
他精神大振，仔细端详着美洲和非洲大陆形状上的不同点。	Complex 8 10 端详
白天，塘面在阳光下泛着绿光，在微风中漾着绿浪；绿色的荷叶铺在水面上，绿叶中点缀着许多粉红的荷苞和荷花，娇嫩而洁净的荷花颤动着，像披着青纱跳舞的少女。	Complex 59 61 颤动
这学年开始时，只要我说他的儿子不用功，他就一把揪住孩子的耳朵往家里拖。	Complex 23 25 揪住
杜暹先生藏书万卷，每卷后都亲题曰：“清俸买来手自校，子孙读之知圣道，卖及借人为不孝。”	Hard 0 2 杜暹
执行死刑的六个枪手在爬满常春藤的墙前站成一排，这墙就是他那天夜晚进行不幸尝试时爬过的布满裂维正要坍塌的墙壁。	Hard 44 46 裂维
但这并未能阻止造礁工作的进行，顽强生长的珊瑚虫不断补偿了海浪造成的破坏，而那些碎了的珊瑚也正好用来填充“森林”中的空隙，起了加固的作用。	Complex 57 59 空隙
郭沫若的散文像他的诗一样，有的写得豪放激越、气势磅礴，也有的写得柔婉清丽、秀美含蓄。	Hard 22 26 气势磅礴
如文章快结束时，有没有必要引用梁元帝《采莲赋》中那么长段质量并不见佳的赋体骈文呢？	Hard 35 39 赋体骈文
战斗游戏时，动物互相亲密地厮打，看似战斗激烈，其实极有分寸，它们配合默契，绝不会引起伤害；研究者认为，战斗游戏可能要比真的战斗更为困难，因为这种游戏要求双方的攻击有分寸，对伙伴十分信赖，动物严格地自我控制，使游戏不会发展成真的战斗。	Complex 13 15 厮打
天之涯，地之角，知交半零落，人生难得是欢聚，惟有别离多……	Hard 11 13 零落
他身后跟着一个火红色头发的巡警，端着一个筛子，盛满了没收来的醋栗。	Complex 30 32 醋栗
后来他又发明了耒、耜，告诉人们如何耕种。	Hard 9 10 耜
这也是千古名句，可是这里的“高树多悲风”却并没有落叶的形象，而“寒风扫高木”则显然是落叶的景况了。	Hard 14 19 高树多悲风
少了一匹战马，败了一场战役。	Complex 11 13 战役
溪西一带山，俱似鹦绿鸦背青，上有腥红云五千尺，开一大洞，逗出缥天，映水如绣铺赤玛瑙。	Hard 39 41 玛瑙
据有考据癖的人说：这就是五通神。	Hard 2 5 考据癖
在時天之下，旋风忽来，使连勃地奇飞，在日光中灿灿地生光，如色火的大雾，旋转而且升腾，弥没太空，使太空旋转而且升勝地闪烁鲁迅憎恶这使雪花永远“如粉，如沙”地旋转飞腾的方的冬天，同时又赞颂这与“凛冽的天宇”奋飞搏战的孤独而低强的“雨的精魂”。	Hard 1 3 時天
列车终于在她的视野里彻底消失了，眼前一片空旷，一阵寒风扑来，吸吮着她单薄的身体。	Complex 30 32 吸吮
元英宗十分向往贞观年间君臣相得的情景，问身边的大臣拜住：“今天可还有魏徵那样敢说话的人？”	Complex 11 15 君臣相得
河面各只彩船上，无数五颜六色的霓虹灯、日光灯齐放光华，闪烁迷离，和水中倒影连成一片。	Hard 15 18 霓虹灯
张择端主要活动于北宋末年至南宋初年，生卒年不详，山东东武人，字正道，又字文友，幼读书游学于汴京，徽宗朝/进入翰林，据张著题跋，后习绘画，擅长界画，工/舟车、人物、市街、城郭，自成一家。	Complex 54 56 翰林
真君道：“兄弟们在此看守巡逻，等我上去寻他。”	Complex 12 14 巡逻
经过一段时间的学习，他有了很大进步，受到了同行的称赞。	Complex 21 23 同行
年纪大，手脚笨，眼睛花，他们觉得自己是不行了。	Complex 8 11 眼睛花
那凤姐家常带着紫貂昭君套，围着那攒珠勒子，穿着桃红洒花袄，石青刻丝灰鼠披风，大红洋皱银鼠皮裙；粉光脂艳，端端正正坐在那里，手内拿着小铜火箸儿拨手炉内的灰。	Complex 49 51 脂艳
这个客官道我酒里有甚么蒙汗药。	Hard 11 14 蒙汗药
在发现镭之后的不断研究中，居里夫人也在不停地变化着。	Hard 3 4 镭
此时此刻，我耳边又回响着充满墨香的书声，快乐童真的歌声，尽情嬉闹的笑声，诲人不倦的心声……	Complex 36 40 诲人不倦
评审会按既定程序一项一项进行。	Complex 4 6 既定
它们依仗长尾巴出色的平衡功能，在树枝上玩着“走钢丝”和“倒立”的把戏；它俩相互推挤，好像竭力要把对方推下树去，可被推的一方总是抓住树枝，巧妙地跳开去，绝不会失足坠地……	Complex 80 82 坠地
大老望着弄渡船的老船夫涎皮的老脸，轻轻地说：	Hard 11 13 涎皮
窃国大盗袁世凯称帝，章太炎曾拟模仿明朝的方孝孺故事，身穿麻衣、手执方杖、痛哭于国门，以此哀悼共和的灭亡。	Hard 39 41 国门
第二，包身工都是新从乡下出来，而且她们大半都是老板娘的乡邻，这一点，在“管理”上是极有利的条件。	Complex 3 6 包身工
尤其是门前的山沟，长满了各种各样的树木，里边还有小松鼠、小兔子、小蚱蜢……	Complex 33 35 蚱蜢
就把我们的油水一古脑儿吞了去！	Complex 7 11 一古脑儿
这些红艳耀目的荷花，高高地凌驾于莲叶之上，迎风弄姿，似乎在睥睨一切。	Hard 29 31 睥睨
幽兰吐秀乔林下，仍自盘根众草傍。	Hard 0 4 幽兰吐秀
至如梁、柱、枋、標、门、窗、墙、瓦、植、阶、栏杆、隔扇、斗拱、正脊、垂脊、正吻、戗兽、正房、厢房、游廊、庭院、夹道等等。	Hard 40 42 戗兽
有一天，牛顿放学回家，看见村子旁边正在安装磨面的风车。	Complex 21 23 磨面
他摇了摇头，笑着说：“吃饭有我，挑粮也应该有我呀！”	Complex 16 18 挑粮
最后是美国总统讲话，他赞美她是一个“高尚的人，忠城的妻子，慈爱的母亲：除了那极艰巨的工作之外，她尽到了妇女的全部天职”。	Complex 56 58 天职
可是，谁也没有想到，突然寒潮降临，北风呼啸，湖面又上冻了。	Complex 19 21 呼啸
我应该感谢母亲，她教给我生产的知识和革命的意志，鼓励我以后走上革命的道路。	Complex 18 20 革命
客到时，果品酒馔只顾将来，不必要问。	Complex 6 12 酒馔只顾将来
最后我送给大家一个公式，来结束我的这场“狗皮膏药”式的演讲，这是美国心理学家荣格的一个公式，我非常赞赏，就是“ＩｐlusWEequalstoFullI“（I+WE=FullI）大家很强调要体现自我价值，体现自我价值，需要把自己溶在“Ｗｅ（我们）”这个大集体里面，最终完全体现自我价值。	Complex 20 24 狗皮膏药
“前进”号在再次进入大气层时会烧毁，这对我那可恶的、臭气熏天的破布来说，是个合适的结局。	Complex 26 30 臭气熏天
父亲愉快地告诉我，他去世后要捐赠所有完好的器官，尤其是眼睛角膜。	Hard 29 31 角膜
余光中说这一段把话说得这么白，是败笔，中学生的水平！	Complex 16 18 败笔
透明的冰山，沸腾的大海，汹涌澎湃的大江大河，丁丁冬冬的泉水，潺潺的溪流，平静的湖水，北国千里冰封，万里雪飘，南国溟溟薄雾，潆漾细雨，还有那挂在红花绿叶上珍珠般晶莹的晨露，蓝天上飘浮的白云，以及危害庄稼的冰雹，所有这一切，气态的、固态的、液态的水，都是水的不同形态。	Hard 56 60 溟溟薄雾
先生拿着戒尺，走到孙中山跟前，厉声问道:“你会背了？”	Hard 4 6 戒尺
又有夜岚数层斗起，如鱼肚白，穿入出炉银红中，金光煜煜不定。	Hard 2 4 夜岚
到了这个时候，诗的平仄逐渐有了定格。	Complex 15 17 定格
黄的，那是土，未开垦的处女土，几百万年前由伟大的自然力所堆积成功的黄土高原的外壳；绿的呢，是人类劳力战胜自然的成果，是麦田，和风吹送，翻起了一轮一轮的绿波——这时你会真心佩服昔人所造的两个字“麦浪”，若不是妙手偶得，便确是经过锤炼的语言的精华。	Complex 8 10 开垦
考察队员和村民们认真仔细地搜索、观察,在附近一共发现了七只成年朱鹮,他们立即投入到紧张的保护朱鹮的工作之中。	Hard 31 33 朱鹮
诸葛亮又下令把船掉过来，船头朝东，船尾朝西，仍旧擂鼓呐喊，逼近曹军水寨受箭。	Complex 33 35 水寨
选作课文时略有删改。	Complex 5 9 略有删改
至如梁、柱、枋、標、门、窗、墙、瓦、植、阶、栏杆、隔扇、斗拱、正脊、垂脊、正吻、戗兽、正房、厢房、游廊、庭院、夹道等等。	Hard 37 39 正吻
于是，“春风又绿江南岸”成为文学史上的名句，王安石千锤百炼炼字炼意，也成为文学史上的佳话。	Complex 29 33 炼字炼意
既已不平凡不单调了，又毋需乎创造。	Hard 11 13 毋需
第一年里，他们共同从事镭和钋的化学离析工作，并且研究他们所得到的活性产物的放射性。	Hard 13 14 钋
最后忍无可忍，终于在他卧室里人脏俱获，先把该书夺回，宣称内急，而他家的厕所是在大门口的，于是我就驾风而逃。	Complex 14 18 人脏俱获
对于这位敬爱的首长，杨光不但知道，还曾亲眼看见过。	Hard 7 9 首长
它被一个小鹅卵石挡住了路，它不是绕过了它，而是倒退着向上登，把它的捕获物跟着往上拽，在小鹅卵石的另一面翻滚了下去。	Complex 33 36 捕获物
还有一条南起紫竹院公园，北至畅春园（进北大校址）南门。	Complex 4 6 南起
又忙携黛玉之手，问：“妹妹几岁了？	Complex 2 3 携
把成功的三个条件拿来分析一下，天资是由“天”来决定的，我们无能为力。	Complex 29 33 无能为力
吉姆站在屋里的门口边，纹丝不动地好像猎犬嗅到了鹌鹑的气味似的。	Complex 23 25 鹌鹑
记得童年与家人在庭院纳凉，母亲总要背诵唐人“银烛秋光冷画屏，轻罗小扇扑流萤”的诗句，其情境真够令人销魂的了。	Hard 30 37 轻罗小扇扑流萤
李白诗曰：“东风已绿瀛洲草，紫殿红楼觉春好。”	Hard 14 21 紫殿红楼觉春好
他举起右臂，手雷在按照灯的光亮中闪闪发光。	Hard 6 8 手雷
船长站在舰桥上，小心翼翼地驾驶着他的“诺曼底”号。	Complex 8 12 小心翼翼
我看见婵娟被人虐待，我看见你挺身而出，指天画地有所争论。	Complex 3 5 婵娟
学会了怎样用潜水镜以后，你就可以背上氧气瓶穿上脚蹼，在小湖或江河里，一边蹬水悠闲地游来游去，一边观察水底。	Hard 23 25 脚蹼
但是如果它比临界值大，宇宙就会坍缩，而时间本身就会在大挤压处终结。	Hard 15 17 坍缩
场地原为粤中造船厂旧址。	Complex 4 6 粤中
我曾屡次发现，每当我感到前途茫茫而灰心丧气时，只要记起很久以前我在那座小悬崖上所学到的经验，我便能应付一切。	Complex 2 4 屡次
我们退到后面，一个辫子很光的却来领我们到了侧面，指出一个地位来。	Complex 9 11 辫子
一种生意盎然之美，一种随处生春之美，读久了就觉得生命很亮丽，很新鲜活泼有力。	Hard 11 15 随处生春
这一来毡靴损坏得可厉害啦，不光是底子，就连底子往上拐弯儿的地方，全都出现了裂纹。	Hard 3 5 毡靴
千佛山、大明湖和趵突泉，是济南的三大名胜，现在单讲趵突泉。	Hard 8 11 趵突泉
如果举办2008年奥运会的荣誉能够授予北京，我可以向你们保证，7年后的北京，一定会让你们为今天的决定而自豪。	Complex 51 53 自豪
两个新年虽照例可以看到军营里和各乡来的狮子龙灯，在小教场迎春，锣鼓喧阗大热闹，到了十五夜晚，城中舞龙耍狮子的镇筸兵士，还各自赤裸着肩膊，往各处去欢迎炮仗烟火。	Hard 54 56 镇筸
这以后，地面上就耸起灌木丛、树木、干草垛。	Complex 10 13 灌木丛
当时我已经处于半靠边的状态，傍晚我们在院子里乘凉，孩子们都劝我把包弟送走，我请我的大妹妹设法。	Complex 22 24 乘凉
比方说不题词；不为别人的书写序；不参加任何成果鉴定会；不出席应景活动(如开幕式、剪彩等)；不出国访问；甚至退出一线工作以后，不到外地开会，连天津也不去。	Hard 30 32 应景
德拉这样做了，可精神上的感慨油然而生，生活就是哭泣、抽噎和微笑，尤以抽噎占统治地位。	Hard 26 28 抽噎
荒丘的颜色酷似虎皮，当地人称虎皮岩。	Complex 5 7 酷似
谷底是奇花异草、亚热带雨林，山坡上生长着温带的常绿阔叶林，峡谷的高处则生长着松柏等寒带的针叶树。	Complex 3 7 奇花异草
汉语的声调和语音的高低、长短都有关系，而古人把四声分为平仄两类，区别平仄的标准似乎是长短，而不是高低。	Hard 27 29 平仄
他知道他终于给打败了，而且一点补救的办法也没有，于是他走回船梢，发现舵把的断成有缺口的一头还可以安在舵的榫头上，让他凑合着掌舵。	Hard 52 54 榫头
至如梁、柱、枋、標、门、窗、墙、瓦、植、阶、栏杆、隔扇、斗拱、正脊、垂脊、正吻、戗兽、正房、厢房、游廊、庭院、夹道等等。	Hard 6 7 枋
科学家创造这一奇迹，并不只是供游人观赏猎奇，更重要的是想通过这项研究，进一步揭示生命的奥秘。	Complex 19 21 猎奇
在最寒冷的日子里，有个年轻女子拖一具小棺材在街头踉跄，小棺材里躺着她冻馁而亡的孩子。	Hard 34 38 冻馁而亡
徽曰：“孔明与博陵崔州平、颍川石广元、汝南孟公威与徐元直四人为密友。	Hard 13 15 颍川
鼹鼠先生来到松鼠太太门前。	Hard 0 2 鼹鼠
1910年他加入同盟会，筹款资助孙中山先生领导的辛亥革命；抗日战争爆发，他担任南洋华侨总会主席，捐资抗日，不顾危险，亲身回国考察战事、慰劳将士。	Hard 24 28 辛亥革命
它没有婆娑的姿态，没有屈曲盘旋的虬枝，也许你要说它不美。	Hard 16 18 虬枝
穿上这身黑，就赛跟地上一桶白浆较上了劲。	Hard 6 8 就赛
整整一个晚上，江雪都在思考对策。	Complex 13 15 对策
这是因为地壳下沉，使原来靠岸的地方变成了海洋的中心。	Hard 4 6 地壳
他身子瑟缩了一下，感觉到鸡皮疙瘩在身上拱起，汗从额头跌了下来，胸口地方像一只小兔兜着，一下一下跳哩。	Complex 3 5 瑟缩
我获得的土地的价格很低，一公顷还不到两个卢布。	Hard 20 22 卢布
树上积满了白雪。	Complex 2 4 积满
撒切尔先生告诉他：为了防止再有人迷路，魔克托尔山洞的出口被封死了。	Complex 29 31 封死
中国婚姻方法的缺陷，才子佳人小说作家早就感到了，他于是使一个才子在壁上题诗，一个佳人便来和，由倾慕——现在就得称恋爱——而至于有“终身之约”。	Complex 65 69 终身之约
有时候，他引诱你到语言文字的穷边涯际，下面是深秘的静默：“此中有真意，欲辨已忘言。”	Hard 29 34 此中有真意
考察队员和村民们认真仔细地搜索、观察,在附近一共发现了七只成年朱鹮,他们立即投入到紧张的保护朱鹮的工作之中。	Hard 46 48 朱鹮
武松走了一程，酒力发作，热起来了，一只手提着哨棒，一只手把胸膛敞开，踉踉跄跄，奔过乱树林来。	Hard 22 24 哨棒
小女孩向画片伸出手去。	Hard 4 6 画片
“蜂儿如一朵小雾稳稳地停在半空；蚂蚁摇头晃脑捋着触须，猛然间想透了什么，转身疾行而去；瓢虫爬得不耐烦了，累了祈祷一回便支开翅膀，忽悠一下升空了；树干上留着一只蝉蜕，寂寞如一间空屋；露水在草叶上滚动，聚集，压弯了草叶轰然坠地摔开万道金光。”	Complex 24 26 触须
鲁提辖坐了主位，李忠对席，史进下首坐了。	Hard 10 12 对席
包扎所的担架不够了，好几个重彩号不能及时送后方医院，耽搁下来。	Hard 13 16 重彩号
到了河边，见那只新船正在装货，许多油篓子搁到河岸边。	Hard 17 20 油篓子
我想到了当年陪同梁思成勘探木塔的年轻学者莫宗江先生后来的回忆:他们爬到了塔顶，但塔刹还有十多米高，除了几根铁索外，没有任何可供攀援的东西。	Hard 40 42 塔刹
老都管见众军所说，自心里也要吃得些，竟来对杨志说：“那贩枣子客人已买了他一桶酒吃，只有这一桶，胡乱教他们头了避暑气。	Complex 27 28 贩
那笼子里的黑老鸹子，长出凤头儿来，也会说话呢！	Hard 5 9 黑老鸹子
嗉囊装满后，它用喙尖抓抓脚底，用沾着唾液的爪擦擦脸和眼睛，然后闭着双眼或者躺在沙上消化食物。	Hard 8 9 喙
不准流一滴血，也不准割得超过或是不足一磅的重量；要是你割下来的肉，比一磅略微轻一点或是重一点，即使相差只有一丝一毫，或者仅仅一根汗毛之微，就要把你抵命，你的财产全部充公。	Complex 82 84 充公
一女愿侍痼疾之夫，《醒世恒言》中还说终于一同自杀的；后来改作的却道是有蛇坠入药罐里，丈夫服后便全愈了。	Hard 4 6 痼疾
但到夜里，我热得醒来的时候，却仍然看见满床摆着一个“大”字，一条臂膊还搁在我的颈子上。	Complex 39 41 颈子
心脏是一名勤劳的鼓手，它以每分钟60—100次的节律发出“同、特、同、特”的声音。	Complex 5 7 勤劳
再进去；他果然躺在草窠里，肚里的五脏已经都给吃空了，手上还紧紧的捏着那只小篮呢。……	Hard 9 11 草窠
他们被挑选出来做角斗士，要被关进角斗士学校进行艰苦野蛮的训练，其目的是在竞技场上“表演”得更精彩，以使看台上的奴隶主们更高兴。	Hard 8 11 角斗士
而且并不使人气闷。	Complex 6 8 气闷
如果没有那些旧房子和路，没有扬起又落下的尘土，没有与我一同长大仍旧活在村里的人、牲畜，没有还在吹刮着的那一场一场的风，谁会证实以往的生活——即使有它们，一个人内心的生存谁又能见证？	Complex 40 42 牲畜
有一种人，读书虽然不多，但他对于人情事理，都很通达，凭借经验，运用心得，“官知止而神欲行，依乎天理，批大郤，导大窾”。	Hard 50 53 批大郤
因为她不明白这笑话有几分真，又不清楚这笑话是谁诌的。	Hard 23 24 诌
古今多少奇丈夫	Hard 4 7 奇丈夫
似乎是我惊醒了爸爸。	Complex 4 6 惊醒
窗子完全打开了，房间里还坐不牢。	Hard 12 15 坐不牢
既然你要求公道，我就给你公道，而且比你所要求的更地道。	Hard 5 7 公道
天上那层灰气已散，不甚憋闷了，可是阳光也更厉害了许多：没人敢抬头看太阳在哪里，只觉得到处都闪眼，空中，屋顶上，墙壁上，地上，都白亮亮的，白里透着点红；由上至下整个的象一面极大的火镜，每一条光都象火镜的焦点，晒得东西要发火。	Complex 11 13 憋闷
这时，一群鸭子“嘎嘎”叫着，“扑通扑通”跳下水。	Complex 8 10 嘎嘎
刘邓大军各部偃旗息鼓，星夜南下，一步步穿越大片淤泥埋没了屋顶的死亡地带——黄泛区。	Complex 11 15 星夜南下
就这样他们还是唱着激昂而热切的号子，那汹涌澎湃的江水号子。	Complex 9 11 激昂
漂载着野花，漂载着山草和林苔的清香，漂载着快乐，漂载着喜悦和云彩的影子，泉水在山箐里响起来了！	Hard 39 41 山箐
刘邓大军各部偃旗息鼓，星夜南下，一步步穿越大片淤泥埋没了屋顶的死亡地带——黄泛区。	Complex 37 40 黄泛区
新华社郑州1948年11月5日电，在人民解放军伟大的胜利的攻势下，南阳守敌王凌云于四日下午弃城南逃，我军当即占领南阳。	Complex 35 37 守敌
小地主还可以在鸟类里散布点舆论，不时讲讲它的年少经历，谈谈它遇到的人，虽说有时不太温柔，可是心眼还不坏。	Complex 13 15 舆论
这是一个亭子形方殿，殿顶把四道垂脊攒在一起，正中安放着一个大圆金宝顶，轮廓非常优美。	Hard 15 17 垂脊
巨大的漕船，舳舻相接，忙碌的船工从停泊在河边的粮船上卸下沉重的粮包，纤夫们拖着船，逆水行驶，一片繁忙景象。	Hard 3 5 漕船
当年小人书便宜。	Hard 2 5 小人书
有弗学，学之弗能弗措也；有弗问，问之弗知弗措也；有弗思，思之弗得弗措也；有弗辨，辨之弗明弗措也；有弗行，行之弗笃弗措也。	Hard 40 47 辨之弗明弗措也
次年四月，清兵包围了扬州。	Hard 5 7 清兵
我把两只猫都带到岸上；至于那条狗，它是在我第一次搬东西上岸的第二天自动跳下船，泅到岸上来找我的，后来作了我多年的忠仆。	Hard 39 40 泅
我不想难堪得无地自容，就尴尬地向姑娘讲明情况，要摘下手表做抵押。	Complex 29 31 抵押
店家去里面切出二斤熟牛肉，做一大盘子将来，放在武松面前，随即再筛一碗酒。	Complex 31 32 筛
我们这里没有现洋钱，只有钞票。	Complex 6 9 现洋钱
他表示相信，有全国人民作坚强后盾，香港特别行政区政府和香港同胞一定能够管理和建设好香港，保持香港长期繁荣稳定，创造香港美好的未来。	Complex 14 16 后盾
大熊猫如今分布地域十分狭窄，仅见于我国四川省的岷山、邛崃山和大小凉山，甘肃省的南缘和陕西省秦岭南麓等海拔2000～3500米的崇山峻岭。	Hard 47 49 南麓
比如一个部落或一个村庄有病毒或细菌，把这村里的人畜都害死了以后，这种病毒或细菌也就灭绝了。	Complex 23 25 人畜
这渴慕是从一个远房的叔祖惹起来的。	Hard 10 12 叔祖
赵王到了渑池，会见了秦王。	Hard 4 6 渑池
时云长在侧曰：“某闻管仲、乐毅乃春秋、战国名人，功盖寰宇；孔明自比此二人，毋乃太过？”	Hard 37 41 毋乃太过
为什么我们这些隐藏在宇宙中某个被遗忘角落里的人类就这样幸运呢？	Complex 7 9 隐藏
入夜，毛毛细雨比猫步还轻，跌进树叶里汇成敲响路面的点点滴滴，泄漏了秘密，很湿，也很诗。	Complex 20 22 敲响
中小户人家，忌讳较少，遇到产妇胎位不正，老娘束手，老娘就会建议：“去请陈小手吧。”	Hard 6 8 忌讳
生活不下去，就一死了之。	Complex 7 11 一死了之
我眺望四周，一片茫无边际的蔚蓝的海，无数波浪闪耀着金鳞；头上，也是这样茫无边际，这样蔚蓝的海——在那儿，温柔的太阳在运行着，宛然在微笑。	Hard 62 64 宛然
林冲和差拨两个在路上，又没买酒吃处，早来到草料场外。	Hard 3 5 差拨
恭喜您，是个男伢子，少爷！	Hard 7 9 伢子
冬天里四面透风，柳木疙瘩火当中架起，一出场一脸正经，一下场凑近火堆，热了前怀，凉了后背。	Hard 10 12 疙瘩
但她大概也即觉到了，说道：“像你似的小孩子，长毛也要掳的，掳去做小长毛。	Hard 26 27 掳
新年才过，她从河边掏米回来时，忽而失了色，说刚才远远地看见几个男人在对岸徘徊，很像夫家的堂伯，恐怕是正在寻她而来的。	Hard 44 46 堂伯
餐桌上饭菜丰盛极了，有烤羊肉串、清炖羊肉、曲曲，还有许多说不出名字的食品。	Hard 21 23 曲曲
可是“客怨，仆泣”，他们都被劝阻了。	Complex 14 16 劝阻
当我站在讲坛上向年轻人宣讲自己所崇奉的信念的时候，我会想起我的启蒙老师们。	Complex 31 33 启蒙
我对他起初并无信心，姑妄从之。	Complex 10 14 姑妄从之
比较早的有葡萄、苜蓿、茉莉、苹果、菠菜等等，近代的像咖啡、可可、柠檬、雪茄、巧克力、冰淇淋、白兰地、啤酒、卡片、沙发、扑克、哔叽、尼龙、法兰绒、道林纸、芭蕾舞等等，都是极常见的。	Hard 72 75 道林纸
那坟地荒草凄凄，古木幽幽。	Complex 10 12 幽幽
一次，在采蒲台，十几个干部和全村男女被敌人包围。	Complex 4 7 采蒲台
终于,四只活泼的小朱鹮钻出蛋壳,来到世界上。	Hard 9 11 朱鹮
阿依穆罕大娘还用糜米放在瓦罐里，做出了一种既像黄酒、又像啤酒、也像喀瓦斯、还像哈萨克夏牧场的酸马奶一样的叫做“泡孜”的饮料，喝上一口，酸、苦、甜、凉、热俱全，我也很喜欢。	Hard 8 10 糜米
这媳妇长得很好看，高高的鼻梁，弯弯的眉，额前一溜蓬松松的留海。	Hard 22 24 一溜
然后我建造了一个云室，在云室中可以看到亚原子粒子留下的踪迹。	Hard 8 10 云室
当时三人坐下，李逵便道：“酒把大碗来筛，不奈烦小盏价吃。”	Hard 18 19 筛
更羸仔细看了看，指着大雁对魏王说：“大王，我不用箭，只要拉一下弓，这只大雁就能掉下来。”	Hard 0 2 更羸
满园春色关不住	Hard 0 4 满园春色
这家伙厉害得很，飞时巨大的翅膀磨得嚓嚓地响。	Complex 17 19 嚓嚓
2008名乐手击缶，声又变成了光——组成让人心跳的数字，和着读秒时刻:“5——4——3——2——1！”	Hard 7 9 击缶
什么都有：稻鸡，角鸡，鹁鸪，蓝背……	Hard 11 13 鹁鸪
那树有一点皴皱，露出老态，但是坚固稳定，树顶像刚炸开的焰火一样繁密。	Hard 5 7 皴皱
它不同于：“美女妖且闲，采桑歧路间；柔条纷冉冉，落叶何翩翩。”	Hard 12 17 采桑歧路间
后来，人们就把在写诗和作文时斟酌文字叫做“推敲”。	Complex 21 23 推敲
它没有婆娑的姿态，没有屈曲盘旋的虬枝。	Hard 16 18 虬枝
它的成分并不和一般通用的意义一样，里面是较少的籼米、锅焦、碎米和较多的乡下人用来喂猪的豆腐渣！	Hard 23 25 籼米
要知道，不论哪种文明，都不是完美无缺的，都有精华和糟粕，所以对涌进来的异文化我们既要“理解”，又要有所“选择”。	Complex 25 27 糟粕
自去肉案上拣了十斤精肉，细细切做臊子。	Hard 16 18 臊子
麋鹿的尾巴是鹿科动物中最长的。	Hard 0 2 麋鹿
水上那一个不再说什么，手脚并用的拍着水傍了码头。	Hard 19 20 傍
这时候，从附近的丛林里飞来一只萤火虫，飘飘忽忽地，闪着幽幽的光。	Complex 19 23 飘飘忽忽
数亿年来，它们进行过亿万次的破坏性侵袭，把个严肃神圣、伟岸如铁的泥岩山体，弄得伤痕累累一片残缺。	Complex 17 19 侵袭
“男爵爱卿，”他厉声言道，“朕想卿也明白，‘陛下’这个称呼在全国范围内只属于孤家一人，再没有旁人称得起‘陛下’了！	Hard 8 10 厉声
她又为我唱起了幽默风趣的童谣，把我的思绪从天上引到人间：	Complex 7 11 幽默风趣
手术完成之后，用相同频率的电脉冲刺激换核卵，让苏格兰黑面羊的卵细胞质与芬多席特母羊乳腺细胞的核相互协调，使这个“组装”细胞在试管里经历受精卵那样的分裂、发育而形成胚胎的过程。	Hard 10 12 频率
新写的《国榷》共104卷，428万4千字，内容比原先的那部更加翔实、精彩，是一部不可多得的明史巨著。	Hard 4 6 国榷
勤读报，会读报，你就会和大千世界息息相通。	Complex 16 20 息息相通
焦渴的找水人，怀着虔诚和崇敬之情，流尽了最后一滴汗，耗完了最后一滴血，倒毙在沙漠里。	Complex 9 11 虔诚
例如《诗经·鲁颂》的《駉》这一首诗里提到马的名称就有16种：“驈”(身子黑而胯下白的)，“皇”(黄白相间的)，“骊”(纯黑色的)，“黄”(黄而杂红的)，“骓”(青白杂的)，“駓”(黄白杂的)，“騂”(红黄色的)，“骐”(青黑成纹像棋道的)，“驒”(青黑色而有斑像鱼鳞的)，“骆”(白马黑鬃)，“駵”(红马黑鬃)，“雒”(黑马白鬃)，“駰”(灰色有杂毛的)，“騢”(红白杂毛的)，“驔”(小腿长白毛的)，“鱼”(两眼旁边毛色白的)。	Hard 179 180 騢
他可不是那种小心眼儿的人。	Complex 6 10 小心眼儿
当时我已经处于半靠边的状态，傍晚我们在院子里乘凉，孩子们都劝我把包弟送走，我请我的大妹妹设法。	Hard 8 10 靠边
一个肩膀宽宽的小伙，肩上垫了一块老蓝布，扛了几枝青竹，竹梢长长的拖在他后面，刮打得石级哗哗作响。……	Complex 43 47 哗哗作响
本着这个精神，他随处留心玩索，无论是阅读或写作，就会逐渐养成创作和欣赏都必需的好习惯。	Hard 12 14 玩索
现在是早已并屋子一起卖给朱文公的子孙了，连那最末次的相见也已经隔了七八年，其中似乎确凿只有一些野草；但那时却是我的乐园。	Hard 5 6 并
秦俑的制作充分体现了中国古代发达的科学技术，令许多国外的科学史家惊叹不已。	Hard 0 2 秦俑
嗉囊装满后，它用喙尖抓抓脚底，用沾着唾液的爪擦擦脸和眼睛，然后闭着双眼或者躺在沙上消化食物。	Hard 0 2 嗉囊
自从古人写了一句“桂林山水甲天下”的诗，多有把它当做品评山水的论断。	Hard 13 16 甲天下
因为它长得粗壮结实，样子也不大好看，还特别在前面加一个“侉”字，叫做“侉叫蛐子”。	Hard 28 29 侉
我手里拿着戒尺站住等他。	Hard 5 7 戒尺
据说，许多年代以前，威尼斯还是一片荒芜的海滩，马可到意大利各地传教，乘船经过里阿托岛海岸，当时风暴骤起，把船刮到荒凉的沼泽地带搁浅了。	Hard 31 33 传教
这时的旅鼠不再胆小怕事，见人就跑，而是恰恰相反，在任何天敌面前它们都显得勇敢异常，无所畏惧，具有明显的挑衅性，有时甚至会主动进攻，真有点天不怕地不怕的样子。	Complex 51 53 挑衅
“大婶子，别撕了，放到这时候的白菜，老帮子脱了五六层，成了核了。”	Hard 18 21 老帮子
情况是危急的，伯瑙德夫人知道，蜡烛燃到金属管处就会自动熄灭，情报就会泄露，同时也意味着他们一家三口的生命将告结束。	Hard 7 10 伯瑙德
春风无迹可寻，但春风一至，江南倏忽绿了，那么突然，又那么自然。	Hard 15 17 倏忽
爸爸竟然也说不出它是什么树，一会儿说是“桧树”，一会又说恐怕是“槭树”，都是奇怪的名称；他只说他小时候就经常来爬它，他们那群小孩子管它叫“大不列颠”，真是莫名其妙。	Hard 32 34 槭树
鲁智深和杨志从此当了山寨寨主。	Complex 0 3 鲁智深
在举行仪式的前一晚，麦隆内夫人把赠予文件给她申阅，她很小心地读完，然后从容地说：	Complex 16 18 赠予
现在，人们用“舍本逐末”来比喻做事不抓住主要问题，而专顺细枝末节。	Hard 26 28 专顺
今年的诺贝尔奖的获得者有：德国的伦琴（物理学奖），他发现了X射线；荷兰的范托夫（化学奖），他发现了化学动力学定律和渗透压定律；德国的贝林（生理学或医学奖），他在血清法的研究方面卓有成就；法国的普吕多姆（文学奖），他在诗歌创作方面颇有建树。	Complex 88 92 卓有成就
她没再往下说，因为父亲指着女婿对她使了个眼色。	Complex 20 22 眼色
四百多年里，它剥蚀了古殿檐头浮夸的琉璃，淡褪了门壁上炫耀的朱红，坍圮了一段段高墙又散落了玉砌雕栏，祭坛四周的老柏树愈见苍幽，到处的野草荒藤也都茂盛得自在坦荡。	Hard 32 34 坍圮
丹顶鹤不论是在地上引吭高歌，还是在天上展翅飞翔，都显得那么高雅。	Complex 0 3 丹顶鹤
只有那树还绿，那树被一重又一重死鱼般的灰白色包围，连根须都被压路机碾进灰色之下，但树顶仍在雨后滴翠，经过速成的建筑物衬托，绿得很年轻。	Complex 26 28 根须
积成峁，堆成墚，又堆积成一大片一大片的塬。	Hard 2 3 峁
他把每件事和每个人都考虑到了，面对惊慌失措的众人，他镇定自若，仿佛他不是给人而是在给灾难下达命令，就连失事的船舶似乎也听从他的调遣。	Complex 51 53 失事
1999年11月20日6时30分，“神舟”一号实验飞船从酒泉卫星发射中心新建成的载人航天发射场飞向太空并于第二天准确着陆。	Complex 40 44 载人航天
又湖南湘西地区部分挑花绣，地材有用桃红色羽纱和水绿色羽纱的，从材料流行时代分析，可知必是六七十年间作品，虽在苗区发现，实是汉人制作。	Complex 26 28 羽纱
茶罢，孔明曰：“昨观书意，足见将军忧民忧国之心；但恨亮年幼才疏，有误下问。”	Hard 27 31 年幼才疏
就在这时，却有两个黑影向它逼近，那是凶恶的加拿大鹞鹰——鸽的天敌。	Complex 24 26 鹞鹰
明屠本畯有一首诗，叙述煎荔枝的方法，说“旋沉荔花蜂酿蜜，清香不减蔗浆寒”，大概是关于荔枝蜜最早的记载。	Hard 28 35 清香不减蔗浆寒
两岸连山，略无阙处。	Hard 0 4 两岸连山
我观察过一次日出，日出比日落缓慢。	Complex 1 3 观察
是围炉的日子，迎新送旧的日子。	Complex 1 3 围炉
母亲生前没给我留下过什么隽永的哲言，或要我恪守的教诲，只是在她去世之后，她艰难的命运，坚忍的意志和毫不张扬的爱，随光阴流转，在我的印象中愈加鲜明深刻。	Hard 12 14 隽永
他的外孙女跟我讲，这些高大挺拔、在初秋的风中微微摇动的树木是托尔斯泰亲手栽种的。	Complex 11 15 高大挺拔
他扬鞭一挥，车便辚辚向前。	Hard 8 12 辚辚向前
天保恰好在那天应向上行，随了陆路商人过川东龙潭送节货，故参加的就只傩送。	Complex 24 26 节货
茶罢，孔明曰：“昨观书意，足见将军忧民忧国之心；但恨亮年幼才疏，有误下问。”	Hard 17 21 忧民忧国
我替人家当牛作马，整整干了一个星期的苦差使，才挣来这枚金币！	Complex 18 21 苦差使
我听得斋公们说：打了天上的星宿，阎王就要拿去打一百铁棍，发在十八层地狱，永不得翻身。	Complex 16 18 阎王
索桥并没有桥墩，高高的竹架代替了他们。	Complex 5 7 桥墩
羊大模大样地走进门去吃园子里的草。	Complex 1 5 大模大样
这个团总少爷自恃手粗腿大，会两套拳术，有几分蛮力，又仗着他父亲的权势，一贯逞强好胜，经常欺侮穷人家的细娃，是赵家场上有名的恶少。	Complex 44 46 欺侮
海面上漂浮着的冰山，在阳光的照射下，闪着莹莹蓝光，犹如一座座水上宫殿。	Complex 20 24 莹莹蓝光
饥饿的虱子，在咬着饿瘦了的弗里茨们。	Complex 13 16 弗里茨
而“小报告”一词，则带有进谗或诬陷的贬义了。	Complex 12 14 进谗
我们知道大地被窒息、被残害。	Complex 11 13 残害
正如次日报载，皇上当时御体不适。	Hard 11 13 御体
我想，凡嗜好的读书，能够手不释卷的原因也就是这样。	Complex 4 6 嗜好
2元劵背面印的图案，为海南岛天涯海角风景区的“南天一柱”奇石。	Complex 14 18 天涯海角
例如《诗经·鲁颂》的《駉》这一首诗里提到马的名称就有16种：“驈”(身子黑而胯下白的)，“皇”(黄白相间的)，“骊”(纯黑色的)，“黄”(黄而杂红的)，“骓”(青白杂的)，“駓”(黄白杂的)，“騂”(红黄色的)，“骐”(青黑成纹像棋道的)，“驒”(青黑色而有斑像鱼鳞的)，“骆”(白马黑鬃)，“駵”(红马黑鬃)，“雒”(黑马白鬃)，“駰”(灰色有杂毛的)，“騢”(红白杂毛的)，“驔”(小腿长白毛的)，“鱼”(两眼旁边毛色白的)。	Hard 190 191 驔
这位宋朝的隐士林和靖，妻梅子鹤，终老是乡，范仲淹曾赞美他“片心高与月徘徊，岂为千钟下钓台。	Hard 29 36 片心高与月徘徊
晚6时15分，象征英国管治结束的告别仪式在距离驻港英军总部不远的添马舰军营东面举行。	Hard 32 37 添马舰军营
刘鹗先生在这一段里连用七八种不同的譬喻，用新鲜的文字，明了的印象，使读者从这些逼人的印象里感觉那无形象的音乐的妙处。	Hard 0 2 刘鹗
把他们夹在书本里，贴在簿子里，固定在标本盒里。	Complex 11 13 簿子
他既不关心他的军队，也不喜欢去看戏，也不喜欢乘着马车去游公园——除非是为了去炫耀一下他的新衣服。	Complex 38 40 炫耀
《红楼梦》第四十九回里就有这样一段：“黛玉换上掐金挖云红香羊皮小靴，罩了一件大红羽绉面白狐皮的鹤氅，系一条青金闪绿双环四合如意绦，上罩了雪帽。”	Hard 61 64 如意绦
据说章太炎不止一次挥杖驱逐前来保护他的宪兵，结果宪兵不得不换上便服伺候章太炎。	Complex 33 35 伺候
穿在身上的100多磅重的铠甲，只能部分地分散我身上的负重。	Complex 26 28 负重
相比之下，钱文最后十六字里日既出的景色，就平淡简单，逊色许多。	Complex 26 28 逊色
他们没打算来看戏，只是把看戏作为一个借口，纷纷扛着椅子来过一个民间节日，来参与这么热闹的一次大社交，缓解一下自己声色感觉的饥渴。	Complex 61 63 饥渴
一群麋鹿悄无声息地向水塘边走去。	Hard 2 4 麋鹿
坐在下面，仿佛置身在一个圆形的乐池里。	Complex 7 9 置身
小獾已经做成了三个小板凳。	Hard 1 2 獾
她扯着我，重找剃头匠。	Complex 7 10 剃头匠
它不同于：“美女妖且闲，采桑歧路间；柔条纷冉冉，落叶何翩翩。”	Hard 24 29 落叶何翩翩
但一到次子傩送年过十二岁时，已能入水闭铺氽着到鸭子身边，再忽然从水中冒水而出，把鸭子捉到，这作爸爸的便解嘲似的说：“好，这种事有你们来作，我不必再下水了。”	Hard 20 21 氽
此游不仅自己饱饫一时眼福，还可以终久地向许多朋友夸耀呢。	Hard 6 8 饱饫
“进士致身卿相为社会心理群趋之鹄的”，这跟科举考试有很大的关系，即汉魏以来中国古代知识人的地位大幅度上升有很大的关系，跟唐代的国力有很大的关系，这是中国文化的复兴之象。	Hard 3 7 致身卿相
可是，什么声音也没有，砰砰城发生了从来没有过的事情，整个城市一片寂静。	Complex 11 14 砰砰城
然后我建造了一个云室，在云室中可以看到亚原子粒子留下的踪迹。	Hard 19 24 亚原子粒子
简直可以说是他除了三害。	Hard 9 11 三害
《红楼梦》第四十九回里就有这样一段：“黛玉换上掐金挖云红香羊皮小靴，罩了一件大红羽绉面白狐皮的鹤氅，系一条青金闪绿双环四合如意绦，上罩了雪帽。”	Hard 47 49 鹤氅
扁鹊早知道蔡恒公要来请他，几天前就跑到泰国了。	Complex 5 8 蔡恒公
譬如，艺术家和社会救济机构的工作人员，完全自觉地选择一种并不能让他们特别能多挣钱的职业，原因很简单，因为这种工作给他们带来乐趣。	Complex 0 2 譬如
另一位先生听得厌烦，把嘴里的香烟屁股扔到街心，睁大了眼睛说：“你们嫌价钱低，不要粜好了。	Hard 40 41 粜
后来，小狐狸在山里到处寻找妈妈，一年、两年，小狐狸不知不觉长大了。	Complex 25 29 不知不觉
他并没有听到这种喘息，他只是从梦里慢慢苏醒过来，觉得有条舌头在顺着他的一只手舐去。	Complex 38 39 舐
他非常愿意彻夜不睡，同这样的看守共度通宵；他愿意跟他们逗趣戏谑，给他们讲他漂泊生涯的故事，然后又悉心倾听他们的趣闻，目的只有一个：使他们保持清醒，以便让他们始终看清，他在笼子里什么吃的东西也没有，让他们知道，他们之中谁也比不上他的忍饿本领。	Hard 27 31 逗趣戏谑
人类在“足不出户”的时代就能够测算出，遥远的星星体积多大，温度多高，有些什么元素，在怎样运动。	Complex 15 17 测算
然而划过了，幔又合拢，跟没有划过的时候一样，透不进一一丝儿风，一会儿，长空一闪，又是那灰色的幔裂了一次缝。	Hard 6 7 幔
考察队员在朱鹮的巢边搭起了窝棚,忍受着风吹雨打、日晒虫叮,精心地观察,守护着这几只朱鹮。	Hard 5 7 朱鹮
我梦想有一天，亚拉巴马州能够有所转变，尽管该州州长现在仍然满口异议，反对联邦法令，但有朝一日，那里的黑人男孩和女孩将能与白人男孩和女孩情同骨肉，携手并进。	Complex 42 46 有朝一日
我国古代就有“结绳记事”的方法。	Complex 7 11 结绳记事
茶罢，孔明曰：“昨观书意，足见将军忧民忧国之心；但恨亮年幼才疏，有误下问。”	Hard 10 12 书意
心中想着，忽见丫鬟话未报完，已进来了一位年轻的公子：头上戴着束发嵌宝紫金冠，齐眉勒着二龙抢珠金抹额；穿一件二色金百蝶穿花大红箭袖，束着五彩丝攒花结长穗宫绦，外罩石青起花八团倭缎排穗褂；登着青缎粉底小朝靴。	Hard 86 88 倭缎
只见云气氤氲来，飞升于文殊院，清凉台，飘拂过东海门，西海门，弥漫于北海宾馆，白鹅岭。	Hard 4 6 氤氲
正在呻吟惨叫的产妇听到他的马脖上的銮铃的声音，立刻就安定了一些。	Hard 17 19 銮铃
与之对应，伤害的策略也有条件，就是在把宿主害死以后必须能够及时转移。	Complex 19 21 宿主
来到这座城市，展现在救援队员面前的是一片悲惨景象：房倒屋塌，失去亲人的大人、孩子在哭泣，空气中弥漫着尸体腐烂后荼发的臭气。	Complex 47 49 弥漫
那只最后从蛋壳里爬出来的小鸭是那么丑陋，他处处挨啄，被排挤，被讪笑，不仅在鸭群中是如此，连在鸡群中也是这样。	Complex 23 25 挨啄
在船上的祖父听到这种带着娇、有点儿埋怨的声音，一面粗声粗气地答道：“翠翠，我就来，我就来！”	Complex 17 19 埋怨
夏季游戏好像体育运动，使北极熊在食物丰富的季节保持了身体的灵活和力量，这对于它们冬季捕食显然大有好处。	Complex 42 44 捕食
至于雨敲在鳞鳞千瓣的瓦上，由远而近，轻轻重重轻轻，夹着一股股的细流沿瓦槽与屋檐潺潺泻下，各种敲击音与滑音密织成网，谁的千指百指在按摩耳轮。	Hard 50 52 滑音
麋鹿的自然繁殖力很低，雌鹿的怀孕期比其它鹿类要长，超过九个半月，且每胎仅产一仔。	Hard 5 8 繁殖力
凤姐听了说道：“怪道既是一家子，我怎么连影儿也不知道！”	Hard 8 10 怪道
母亲骄傲，腹部的妊娠纹象征孕育和新生；遇害者脖颈上可疑的道道抓痕，身体上深浅不一的刀伤，组成罪孽的恐怖条痕——斑纹无处不在，将两极秘密地衔接，像族徽，凝聚着世袭的生和死，荣与辱。	Complex 78 80 世袭
早晨起来，就淅淅沥沥的，我还高兴地说：“春雨贵如油；今年来得这么早！”	Hard 20 25 春雨贵如油
我渐渐感觉我奏出了真正的音乐，那些美妙的音符从琴弦上缓缓流淌着，充满了整个林子，充满了整个心灵。	Complex 28 30 流淌
手术完成之后，用相同频率的电脉冲刺激换核卵，让苏格兰黑面羊的卵细胞质与芬多席特母羊乳腺细胞的核相互协调，使这个“组装”细胞在试管里经历受精卵那样的分裂、发育而形成胚胎的过程。	Hard 13 16 电脉冲
结果是从轻发落予以开释，但是厨师坚持不能不稍予膺惩，即在猫身上原来的铁丝上系一只空罐头，开启街门放她一条生路。	Hard 21 25 稍予膺惩
茶罢，孔明曰：“昨观书意，足见将军忧民忧国之心；但恨亮年幼才疏，有误下问。”	Hard 25 26 恨
但是，当时没有人提起，有没有多少人知道“邓稼先”的名字。	Complex 20 23 邓稼先
麦隆内夫人似乎比居里夫人还要羞怯，她以记者为业已有二十多年了，可是在这个心灵毫不设防的黑衣女士面前，竟问不出一句话来。	Complex 0 3 麦隆内
州平曰：“山野之夫，不足与论天下事，适承明问，故妄言之。”	Hard 10 17 不足与论天下事
可惜煞您了，您的脑子那么好，怎么就不把您留下，留下个我干啥呀……	Hard 2 3 煞
这些朱砂的，丹红的，紫霭色的群峰，前拥后簇，高矮参差。	Hard 10 12 紫霭
这种台子分作两种：一种叫做墙台，台面与城墙顶部高低差不多，只是凸出一部分于墙外，外边砌有垛口，台上还有遮避风雨的简单房子。	Complex 42 43 砌
后来，鲲变成了一只大鸟，名字叫作鹏。	Hard 3 4 鲲
更羸说：“我可以试一下。”	Hard 0 2 更羸
广场北面乾清门以内叫“内廷”，是皇帝和后妃们起居生活的地方，主要建筑有乾清宫、交泰殿、坤宁宫和东六宫西六宫。	Complex 11 13 内廷
由于草木足够作它们的食粮，由于它们有充分的东西来满足它们的食欲，又由于它们对动物的肉毫无兴趣，所以它们绝不对其他动物作战，也绝不互相作战，也不互相争夺生存资料。	Hard 77 79 资料
不过，他老是吮吸着，咀嚼着那只小驯鹿的碎骨头，这是他收集起来随身带着的一点残屑。	Complex 10 12 咀嚼
江理以“从者七人，二僧与俱”，组成一支浩浩荡荡的登山队，“一仆前持斧斤，剪伐丛莽，一仆鸣金继之，二三人肩糗执剑戟以随。”	Hard 48 58 二三人肩糗执剑戟以随
我把第二个烟头啐了出去，落到干草垫之间的过道里。	Hard 7 8 啐
敬字为古圣贤教人做人最简易、直捷的法门，可惜被后来有些人说的太精微，倒变得不适实用了。	Complex 14 16 直捷
晴天是好天气，晒果脯的大儿子会高兴；下雨也是好天气，做伞的小儿子会高兴。	Hard 8 10 果脯
我们来到这块圣地也是为了提醒美国，现在是非常急迫的时刻。	Complex 22 24 急迫
时云长在侧曰：“某闻管仲、乐毅乃春秋、战国名人，功盖寰宇；孔明自比此二人，毋乃太过？”	Hard 29 36 孔明自比此二人
我们都知道，“私订终身”在诗和戏曲或小说上尚不失为美谈（自然只以与终于中状元的男人私订为限），实际却不容于天下的，仍然免不了要离异。	Complex 50 53 不容于
从宇宙飞船上看地球，地球发出耀眼的蓝色和白色的光芒，在茫茫宇宙中，显得特别美丽。	Complex 14 16 耀眼
这工作好好玩，所以我盼望天一直不要晴起来，曲会愈来愈多，我就可以天天滚在谷子里拣曲，不用读书了。	Hard 39 41 拣曲
不愿施舍罢了，何必捉弄人呢？	Complex 2 4 施舍
我想，不止是这江面上众多的升帆的货船和鸣笛的汽轮，那来往穿梭的舢板和驳船，不止是停泊在江心的钻探船，不止是下关码头两旁长长的仓库、堆栈和高楼，使你的心好像黎明一般的舒畅，青春一般的欢愉。	Complex 46 49 钻探船
就是这样，宙斯还觉得不解恨，又派了一只凶恶的鹫鹰，每天去啄食普罗米修斯的肝脏。	Hard 22 24 鹫鹰
众邻居道：“老爷，恭喜高中了。	Complex 11 13 高中
邻居见他不信，劈手把鸡夺了，掼在地下，一把拉了回来。	Hard 14 15 掼
不更事的勇敢的少年，往往敢于给人解决疑问，选定医生，万一结果不佳，大抵反成了怨府，然而一用这说不清来作结束，便事事逍遥自在了。	Hard 38 40 怨府
比较早的有葡萄、苜蓿、茉莉、苹果、菠菜等等，近代的像咖啡、可可、柠檬、雪茄、巧克力、冰淇淋、白兰地、啤酒、卡片、沙发、扑克、哔叽、尼龙、法兰绒、道林纸、芭蕾舞等等，都是极常见的。	Hard 8 10 苜蓿
秦王又手捧住璧，一边看一边称赞，绝口不提十五座城的事。	Hard 6 7 璧
书桌上的一盆“水横枝”，是我先前没有见过的：就是一段树，只要浸在水中，枝叶便青葱得可爱。	Hard 7 10 水横枝
进入三层仪门，果见正房厢庑游廊，悉皆小巧别致，不似方才那边轩峻壮丽；且院中随处之树木山石皆在。	Complex 18 22 小巧别致
这闭着的眼睛便看见一切圆满，当前的苦痛不过是“天之将降大任于是人也，必先苦其心志，劳其筋骨，饿其体肤，空乏其身，行拂乱其为”。	Hard 23 33 天之将降大任于是人也
不过珊瑚虫也有它的“娇气”，它怕冷，怕黑暗，怕浑浊的海水，因此一般只能在温度不低于二十摄氏度、深度不超过八十米的清澈海水中生存。	Complex 56 58 清澈
第二天小光和小胖请了假,连学校的自然课老师也眼着考察队员一起参加寻找朱鹮的工作。	Hard 34 36 朱鹮
于是，伯父家盖房，想以它垒山墙，但苦于它极不规则，没棱角儿，也没平面儿；用錾破开吧，又懒得花那么大气力，因为河滩并不甚远，随便去掮一块回来，哪一块也比它强。	Hard 64 65 掮
奥别多菲尔先生，过去教马思聪兄时，每月收学费二百法郎（当时约合华币十元左右）。	Hard 24 26 法郎
故必有卓绝之士，以身作则，力矫颓俗，诸君为大学学生，地位甚高，肩此重任，责无旁贷，故诸君不惟思所以感已，更必有以励人。	Complex 3 7 卓绝之士
突然，四面八方响起了枪声。	Complex 3 7 四面八方
时云长在侧曰：“某闻管仲、乐毅乃春秋、战国名人，功盖寰宇；孔明自比此二人，毋乃太过？”	Hard 19 23 战国名人
白开水清洁、解渴，还含有其他饮料不具备的生物活性，是质优价廉的饮料。	Hard 22 24 活性
我所爱的北平不是枝枝节节的一些什么，而是整个儿与我的心灵相黏合的一段历史，一大块地方，多少风景名胜，从雨后什刹海的蜻蜓一直到我梦里的玉泉山的塔影，都积凑到一块，每一细小的事件中有个我，我的每一思念中有个北平，只是说不出而已。	Complex 45 49 风景名胜
他听见脚步声音，抬起头来，饱经风霜的脸上现出难以忍受的痛苦。	Complex 13 17 饱经风霜
武松用左手紧紧地揪住大虫的顶花皮，空出右手来，提起铁锤般大小的拳头，使尽平生气力只顾打。	Complex 13 16 顶花皮
革命样板戏当然是含有意识形态的，但那些意识形态同这样的观众有什么关系吗？	Hard 2 5 样板戏
大海庄严地伸出臂儿来接引他，他一声不响地流人她的怀里。	Complex 10 12 接引
因为它长得粗壮结实，样子也不大好看，还特别在前面加一个“侉”字，叫做“侉叫蛐子”。	Hard 35 39 侉叫蛐子
来到塘边，只见满塘浮光跃金，如繁星闪烁。	Hard 9 13 浮光跃金
我有一天在积雨少住的早晨和德熙从联大新校舍到莲花池去。	Hard 5 9 积雨少住
有人提出克隆人会导致人类基因库的单一性，多样性的丧失对人类的前途不利。	Complex 4 7 克隆人
应用的物件已经搬完，家中由忙乱转成静肃了。	Complex 17 19 静肃
这样的游记不但感性单薄，文字也平凡，多袭前人之句。	Hard 19 20 袭
孙晋芳悔恨自己心胸不宽阔，她懂得了自己的喜怒哀乐、自己的情绪起伏会直接影响队员，影响胜负，于是决心继续磨练自己，要把心海中的暗礁一块一块炸平。	Complex 20 24 喜怒哀乐
正如孔子所说：“君子和而不同。”	Hard 8 14 君子和而不同
这种新物质的放射性极强，极少量的镭散布在矿石中，就是一些触目的现象的来源，很容易观察或测量。	Complex 28 30 触目
夏天，我们喜欢自己做抄网，去河边捉小鱼和小虾。	Hard 10 12 抄网
这才有了千古名句“鸟宿池边树，僧敲月下门。”	Hard 9 11 鸟宿
桃花心木为什么无缘无故会枯萎？	Complex 7 11 无缘无故
但是，朋友，难道我就能忍住满心的欢喜和激动，不向你吐出我心中的“咿哑”？	Hard 32 34 咿哑
现在她只剩了一个光身了。	Hard 8 10 光身
比如说苏东坡的“惠山烹小龙团”诗里三四两句“独携天上小团月，来试人间第二泉”，“天上小团月”是由“小龙团”茶联想起来的，如果你不知道这个关联，原文就简直不通。	Hard 8 14 惠山烹小龙团
有诗为证:“丹崖夹石柱，菌萏金芙蓉”。	Hard 12 14 菌萏
更复射，终不能入石矣。	Hard 0 3 更复射
今诸君苟不于此时植其基，勤其学，则将来万一因生计所迫，出而仕事，但任讲席，则必贻误学生；置身政界，则必贻误国家。	Hard 27 31 出而仕事
鲍娅你自己可以去查查明白。	Complex 0 2 鲍娅
它没有婆娑的姿态，没有屈曲盘旋的虬枝。	Hard 3 5 婆娑
比如说苏东坡的“惠山烹小龙团”诗里三四两句“独携天上小团月，来试人间第二泉”，“天上小团月”是由“小龙团”茶联想起来的，如果你不知道这个关联，原文就简直不通。	Hard 34 37 第二泉
只是它的联想的意义迷离不易捉摸，它可以联想到燃烧弹，鸦片烟榻，庙里焚香，“一川烟水”，“杨柳万条烟”，“烟光凝而暮山紫”，“蓝田日暖玉生烟”……	Hard 62 69 蓝田日暖玉生烟
七十年代的台北不需要这些，一个乐队接一个乐队便遣散尽了。	Complex 23 25 遣散
擂鼓打锣的，多坐在船只的中部，船一划动便即刻嘭嘭铛铛把锣鼓很单纯的敲打起来，为划桨水手调理下桨节拍。	Complex 22 26 嘭嘭铛铛
从锭子上取下穗子，也像从果树上摘下果实，劳动以后收获的愉快，那是任何物质享受都不能比拟的。	Hard 1 3 锭子
武松道：“你不信时，只看我身上兀自有血迹。”	Complex 15 17 兀自
人们的诵经声和讨价还价的嘈杂声混在一起，香炉中吐出的桑烟香味与外国香水的气味混在一起，古老质朴的藏戏唱腔与节奏激烈的迪斯科乐曲混在一起……。	Hard 50 52 唱腔
在病床前苦苦服侍了他数年的养母，悲声大放：“我怎么就把您服侍下个这样儿……	Hard 30 32 下个
舒活舒活筋骨，抖擞抖擞精神，各做各的一份儿事去，“一年之计在于春”;刚起头儿，有的是工夫，有的是希望。	Hard 25 32 一年之计在于春
有诗为证:“丹崖夹石柱，菌萏金芙蓉”。	Hard 6 8 丹崖
这个鳏夫两只眼睛睁得老大，愣在那儿，一下子糊涂了。	Hard 2 4 鳏夫
及至始皇，奋六世之余烈，振长策而御宇内，吞二周而亡诸侯，履至尊而制六合，执敲扑而鞭笞天下，威振四海。	Hard 28 29 履
然而，一看到玻璃窗内成堆的头发和婴儿的鞋子，一看到用以关押被判处绞刑的死囚的牢房时，他们就不由自主地停下脚步，浑身发抖。	Complex 30 32 判处
他没有找到比尔的踪迹。	Complex 8 10 踪迹
假如我拥有一切，我就无所用心。	Hard 10 14 无所用心
现在只有四个人继续走路了，但灾难又降临到头上。	Complex 17 19 降临
接着爷爷又把毡靴往水里浸了一遍，结果整个毡靴面子上全蒙了一层冰。	Complex 20 22 毡靴
陈小手常常骑着白马赶着到各处去接生，大家就把白马和他的名字联系起来，称之为“白马陈小手”。	Complex 15 17 接生
那瀑布从上面冲下，仿佛已被扯成大小的几绺；不复是幅整齐而平滑的布。	Hard 18 20 几绺
但段政府就有令，说她们是“暴徒”！	Complex 13 15 暴徒
这一道工序技术难度很高，窑内温度始终要保持在800℃～940℃，才能使陶俑各部分受热均匀，烧出后“视之色如青石，扣之声如磬玉”。	Hard 49 55 视之色如青石
表演的尾声，也是最高潮，在欢乐的音乐声中，象群翩翩起舞，观众都拥到了宽阔的场地上，人群和象群混杂在一起舞之蹈之，热烈的气氛感染了在场的每一个人。	Complex 23 27 翩翩起舞
每年秋天，我的庶祖母同我到田里去“监割”（顶好的田，水旱无忧，收成最好，佃户每约田主来监割，打下谷子，两家平分），我总是坐在小树下看小说。	Hard 7 10 庶祖母
传说远古时候，在遥远的北海有一条特别大的鱼，它的名字叫作鲲。	Hard 28 29 鲲
当我们从生物的世界到人类的社会，一以贯之地看待寄生策略的时候，便可望获得一种不卑不亢、不愠不火、不喜不哀的态度。	Hard 16 20 一以贯之
船出了濑户内海，航行在广阔的海面的时候，聚集在甲板上的人们之中，有一位风度极佳，引人注目，年纪四十左右的高贵妇女，女佣和打杂儿的片刻不离左右。	Complex 3 7 濑户内海
云雾弥漫山谷，它是茫茫的大海；云雾遮挡山峰，它又是巨大的天幕。	Complex 2 4 弥漫
骆驼的腿上有一大片胼胝，它就是趴在被太阳晒得滚热的沙子上，也不会烫伤。	Hard 9 11 胼胝
我买了一张票，本是对于劝募人聊以塞责的，然而似乎又有好事家乘机对我说了些叫天不可不看的大法要了。	Complex 11 14 劝募人
宴会还没结束，消息已达上海。	Complex 0 2 宴会
于是人们就得到租金，这也是一种收入，所根据的事实是，人们拥有这辆载重汽车。	Complex 32 36 载重汽车
一丈青大娘骂人，就像雨打芭蕉，长短句，四六体，鼓点似的骂一天，一气呵成，也不倒嗓子。	Complex 10 14 雨打芭蕉
这双手让这位３２岁的年轻林业工人，成为伊春林区最年轻的育林功臣，获得全国‘五一’劳动奖章。	Complex 27 31 育林功臣
那些属于所谓同属的生物都是另一个并且一般是已经绝灭的物种的直系后代，这与任何一个物种的公认的变种是该物种的后代，是同样的情形。	Hard 6 8 同属
这次回到家，他当即到老信客的坟头烧了香，这位老人已死去多年。	Hard 11 13 信客
当想到大白天里正是日上中天的时候，我国十一亿公民却在同一时间都进入梦乡，不免有某种荒诞之感。	Complex 41 43 荒诞
武松放了手，来松树边寻那打折的棒橛，拿在手里，只怕大虫不死，把棒橛又打了一回。	Hard 15 17 棒橛
老师总是如此善解人意。	Complex 6 10 善解人意
四十多个青年的血，洋溢在我的周围，使我艰于呼吸视听，那里还能有什么言语？	Complex 9 11 洋溢
将军既帝室之胄，信义著于四海，总揽英雄，思贤如渴，若跨有荆、益，保其岩阻，西和诸戎，南抚彝、越，外结孙权，内修政理；待天下有变，则命一上将将荆州之兵以向宛洛，将军身率益州之众以出秦川，百姓有不箪食壶浆以迎将军者乎？	Hard 3 7 帝室之胄
按照古代寓言书的记载，谁能解开奇异的高尔丁死结，谁就注定成为亚洲王。	Hard 21 23 死结
总面积11公顷，其中水面3.	Complex 5 7 公顷
这时，数十只幼龟已成了嘲鸫、海鸥、铿鸟的口中之食，我们的向导摘下头上的棒球帽，迅速抓起十数只幼龟，放进帽中，向海边奔去。	Hard 11 13 嘲鸫
夏天，我们喜欢自已做抄网，去河边捉小鱼和小虾。	Complex 10 12 抄网
同样的道理，革命样板戏宣称要打倒的那些旧时代文艺，那些以前也在这里上演过的剧目，同这些观众有没有关系或者有多大的关系？	Complex 8 11 样板戏
他理直气壮地说：“这都是报上明明白白叠载出来的。”	Hard 18 20 叠载
一条清澈见底的小溪，终年潺潺地环绕着村庄。	Hard 12 14 潺潺
让我们眼前浮现的是一个个在烈日和寒风中工作的辛勤劳动者，况且他们还要拉家带口，供子女上学。	Complex 34 38 拉家带口
她一向就想望着得人欢心，被人艳漢，具有诱惑力而被人追求。	Hard 14 16 艳漢
梁中书道：“礼物多已拴缚完备，如何又去不得？”	Hard 10 12 拴缚
老人抬起头，微笑从他的脸上溢出：“你好，小姑娘。	Complex 13 15 溢出
美猴王领一群猿猴、猕猴、马猴等，分派了君臣佐使，朝游花果山，暮宿水帘洞，合契同情，不入飞鸟之丛，不从走兽之类，独自为王，不胜欢乐。	Hard 36 40 合契同情
我们说《雪》是寓意深邃的撒文诗，就是说它并非如有的研究者所说的那样，仅仅是一篇“绝好的眷念故乡，回忆儿时的抒情小品文”，在故乡的自然景色的描绘中流露了“鲁迅心灵”里一种“深刻的恬适的回味”。	Complex 43 45 眷念
我是母亲的独根苗，您救了我的命，……	Hard 5 8 独根苗
为此，新加坡人只建绿篱不建围墙，从1971年开始大种其树，大铺草坪，连天桥、候车棚、电线杆都攀上藤蔓，使城市环抱在绿色之中。	Complex 48 50 藤蔓
山川不同，便风俗区别，风俗区别，便戏剧存异；普天之下人不同貌，剧不同腔，京、豫、晋、越、黄梅、二簧、四川高腔，几十种品类；或问：历史最悠久者，文武最正经者，是非最汹汹者？	Complex 22 26 普天之下
比如要做到“各美其美、美人之美”，也就是各种文明教化的人，不仅欣赏本民族的文化，还要发自内心地欣赏异民族的文化；做到不以本民族文化的标准，去评判异民族文化的“优劣”，断定什么是“糟粕”，什么是“精华”。	Complex 24 26 教化
杨志又问道：“你等莫不是歹人”那七人道：“你颠倒问，我等是小本经纪，那里有钱与你。”	Hard 22 24 颠倒
这话通常是她的母亲训导她的。	Complex 9 11 训导
“不可上，乃止”，他们没上去。	Hard 5 7 乃止
阳光一照，丹崖贴金。	Complex 5 9 丹崖贴金
它巍巍然撑立在高原之上，给人以生命伟力的强大感召。	Complex 1 4 巍巍然
真要勉用文字来着色，也不过像谢灵运的一些名句“云日相晕映，空水共澄鲜”或是“出谷日尚早，入舟阳已微。	Hard 44 49 入舟阳已微
旧耻已湔雪，中国应新生。	Hard 3 5 湔雪
这两日酒客稀少，违了他钱限，怕他来讨时，受他羞耻。	Complex 5 7 稀少
1933年，他刚到美国避难的时候，总统请他到白宫来做过客。	Complex 11 13 避难
溪西一带山，俱似鹦绿鸦背青，上有腥红云五千尺，开一大洞，逗出缥天，映水如绣铺赤玛瑙。	Hard 28 32 逗出缥天
不要连续不断地开玩笑，说俏皮话，讲笑话，弄得旁边的客人心烦，尤其是重复别人已经说过、听你说话的人已经听过的笑话，那更加让人厌倦。	Complex 61 63 厌倦
他生就一副多毛的脸庞，植被多于空地，浓密的胡髭使人难以看清他的内心世界。	Hard 21 23 胡髭
酒保唱了喏，认得是鲁提辖，便道：“提辖官人，打多少酒？”	Hard 2 3 唱
此时，《歌唱祖国》的豪迈旋律以柔板的方式表现出来，令人心潮澎湃。	Hard 15 17 柔板
均遂进文房四宝。	Hard 3 7 文房四宝
亿万斯年，谁能说清从哪一刻起，不分季节，不分昼夜，不知疲倦的西风带，就开始施展它的法力？	Hard 30 33 西风带
有时捏住笼子，它会从竹篦的洞里咬你的指头肚子一口。	Hard 10 12 竹篦
于是架起两支橹，一支两人，一里一换，有说笑的，有嚷的，夹着潺潺的船头激水的声音，在左右都是碧绿的豆麦田地的河流中	Hard 29 31 潺潺
它好肥，整个身子好像一个蓬松的球儿。	Complex 12 14 蓬松
这些小小的荣光，使我悟到一点道理：作文，首先构思要别出心裁，落笔也要有点与众不同的鲜味才好。	Complex 36 40 与众不同
清清的泉水从井底汩汩地冒出来，人们欢呼雀跃，争先恐后地捧起井水喝。	Hard 8 10 汩汩
这种枝条不剪掉，到了春天就会疯长起来，把许多养分夺走。	Complex 22 24 养分
靠外的一面则用砖砌成高近两米的垛口。	Hard 15 17 垛口
在这以前，爱因斯坦决心关起门来搞统一场论。	Hard 18 20 场论
哲尔赛的旅行成了我们的心事，成了我们时时刻刻的渴望和梦想。	Hard 0 3 哲尔赛
但这一次不同：永远都不会再有港督旗帜从这里升起了。	Complex 14 16 港督
他聚集起许多细流，合成一股有力的洪涛，向下奔注，他曲折的穿过了悬崖峭壁，冲倒了层沙积土，挟卷着滚滚的沙石，快乐勇敢地流走，一路上他享受着他所遭遇的一切，有时候他遇到巉岩前阻，他愤激地奔腾了起来，怒吼着，回旋着，前波后浪地起伏催逼，直到冲倒了这危崖，他才心平气和地一泻千里。	Hard 82 84 巉岩
新式构造，用不着争座位，便放了心，延宕到九点钟才去，谁料照例，人都满了，连立足也难，我只得挤在远处的人丛中看一个老旦在台上唱。	Hard 17 19 延宕
文字记者眼观六路，耳听八方，手不停地作笔记。	Complex 9 13 耳听八方
章太炎谈兴正浓，意犹未尽，让朋友就在牢里吃，朋友正色说：你正为民国存亡绝食，我怎么忍心据案大嚼。	Hard 43 47 据案大嚼
目前实际生活中，作风常常指机关干部的工作方法与效率，如作风拖拉，作风生硬，缺少民主作风，作风雷厉风行等说法，系指工作中表现的个人特点是性格与习惯方面的特点，至于经验、知识、智商方面的状况则用“水平”一词来表示，道德特点用“品质”（原专指物品的质量质地的，指人则称品格。	Complex 8 10 作风
尤其我是女孩子，蒸糕时，脚都不许搁住灶孔边，吃东西不许随便抓．因为许多都是要先供佛与祖先的。	Complex 18 20 灶孔
积成峁，堆成墚，又堆积成一大片一大片的塬。	Hard 6 7 墚
青的草，绿的芽，各色鲜艳的花，都像赶集似的聚拢来，形成了灿烂无比的春天。	Hard 17 19 赶集
那只雄吐绶鸡一生下来脚上就有距，因此他就以为自己是一个皇帝。	Hard 14 15 距
宋洪迈《容斋续笔》中指出：这首诗原作“春风又到江南岸”，几经推敲，改了几次才定了“绿”字。	Hard 4 7 容斋续
屋子里也遭了劫难，连枕头都给刺刀挑破了。	Complex 6 8 劫难
然后，一种奇怪的、激动人心的活动开始了：草场上的雾气越来越快地往上升，被阳光照成一片银白色。	Complex 9 13 激动人心
一辆马车把他撞倒了，从他身上轧了过去。	Hard 14 15 轧
真君笑道：“那猴儿才自变座土地庙哄我，我正要捣他窗棂，踢他门扇，他就纵一纵，又渺无踪迹。	Hard 24 26 窗棂
它那带锯齿的大腿被黄翅飞蝗泥蜂的前足压住，无法发挥进攻性武器的作用，它的双颚被飞蝗泥蜂的后腿顶得离开老远，虽然张得大大的，咄咄逼人，却咬不到敌人的任何部位。	Hard 36 38 双颚
于是，飞卫开始教他怎样开弓，怎样放箭。	Complex 11 13 开弓
长的草里是不去的，因为相传这园里有一条很大的赤练蛇。	Hard 22 25 赤练蛇
在夏天，因为棚顶是玻璃的，棚屋里面燥热得像温室。	Complex 17 19 燥热
在中国最早的新闻学著作之一《实际应用新闻学》中，邵飘萍主张记者“其脑筋无时休息，其耳目随处警备，网罗世间一切事物而待其变。”	Hard 33 35 脑筋
我梦想有一天，在佐治亚的红山上，昔日奴隶的儿子将能够和昔日奴隶主的儿子坐在一起，共叙兄弟情谊。	Complex 18 20 奴隶
我计算着我的归期，计算这“绿囚”出牢的日子。	Complex 6 8 归期
有弗学，学之弗能弗措也；有弗问，问之弗知弗措也；有弗思，思之弗得弗措也；有弗辨，辨之弗明弗措也；有弗行，行之弗笃弗措也。	Hard 36 39 有弗辨
他于是做了一间很小很小的房子，仅仅搁得下他一个人，外加一把锤子和一个刨子。	Hard 34 36 刨子
这孩子花了整整一年功夫用玳瑁铅笔刀在课桌上刻自己的姓。	Hard 12 14 玳瑁
岛上的灯光水塔因此也成为航标灯塔。	Complex 12 15 航标灯
我捧着准备献给江主席的献花，又是兴奋，又是激动，竟顾不得擦一下脸上的雨水。	Complex 25 28 顾不得
沿途会看到许许多多出人意外的美景。	Complex 9 13 出人意外
那七个客人说道：“我只道有歹人出来，原来是如此。	Complex 13 15 歹人
高楼大厦的霓虹灯光彩夺目，热情欢迎来自五洲四海的游客。	Hard 5 8 霓虹灯
透明的冰山，沸腾的大海，汹涌澎湃的大江大河，丁丁冬冬的泉水，潺潺的溪流，平静的湖水，北国千里冰封，万里雪飘，南国溟溟薄雾，潆漾细雨，还有那挂在红花绿叶上珍珠般晶莹的晨露，蓝天上飘浮的白云，以及危害庄稼的冰雹，所有这一切，气态的、固态的、液态的水，都是水的不同形态。	Hard 61 65 潆漾细雨
云海汩汩地围着山头，大有海中孤岛的虚幻感。	Hard 2 4 汩汩
大水车在河边缓缓地转动着，从滔滔激流里吞下一木罐一木罐的黄水，倾注进木槽，流到渠道里去。	Complex 19 21 吞下
“乡亲”还沽了一点酒，向熟肉店里买了一点肉，回到停泊在万盛米行船埠头的自家的船上，又从般梢头拿出盛着咸菜和豆腐汤之类的碗碟来，便坐在船头开始喝酒。	Hard 5 6 沽
我正在左右搜寻,立明对我努劝嘴——只见不远处站着一个穿夹克衫的壮汉,一脸木然,好像根本不知道发生的事。	Complex 27 30 夹克衫
我惨淡无神地提着书包，抱着绝望的心情走进最末一家书店。	Complex 1 5 惨淡无神
等到田野上腾起一层薄雾，月亮，像是偷偷地睡过一觉，重又悄悄地回到天边，方才挎着装满麦穗的篮子，走回自家那破窑洞的时候，她想的又是什么呢？	Complex 53 55 窑洞
他并没有听到这种喘息，他只是从梦里慢慢苏醒过来，觉得有条舌头在顺着他的一只手舐去。	Complex 8 10 喘息
它们将短硬的喙像北方农妇在缸沿砺刀那样，在枝上反复擦拭。	Hard 15 17 砺刀
自更新世以来，每年三月，从中国海到西伯利亚，从幼发拉底河到伏尔加河，从尼罗河到摩尔曼斯克，从林肯郡到斯匹次卑尔根群岛，大雁都要吹起联合的号角。	Complex 68 70 号角
“你只有一克镭么？”	Hard 6 7 镭
于是，我伸手拿起了笔，在稿纸上写下一行字：“蚂蚁是令人感慨的动物。”	Complex 12 14 稿纸
使臣一听，很不高兴地说：“我是奉了敝国国君之命前来问候您的，可是您不先问候敝国国君，反倒先问起庄稼，这分明是先贱而后贵。	Complex 0 2 使臣
妻子和我商议，我们是不是也把屋子糊一下，就用我那些报纸。	Complex 4 6 商议
刘部进入大别山，陈赓部进入伏牛山，已形成椅角之势，从此中原无宁日矣……	Hard 8 11 陈赓部
在夏天的太阳下挺着颈子急走的人，会像猎犬一样奔到树下，吸一口浓阴，仰脸看千掌千指托住阳光，看指缝间漏下来的碎汞。	Complex 30 32 浓阴
现在，你作肉排吧。	Complex 4 7 作肉排
少焉，月出寒阴，微明散布石上，松声倏然自万壑来，客皆悚视寂，觉境愈清，思愈远。	Hard 3 7 月出寒阴
离开北平一年了，我怀念着我的圆窗和绿友。	Hard 17 19 绿友
⑸“秩秩斯干幽幽南山”：语见	Hard 2 10 秩秩斯干幽幽南山
1900年，“八国联军”入侵北京，最后一群麋鹿惨遭厄运，有的被杀戮，有的被装上西去的轮船。	Complex 25 27 厄运
他把旱烟锅子朝鞋底上磕着：“娃呀，你太小哩。”	Complex 10 11 磕
当人类的胚胎成长到5周左右时，手就出现了，但非常小，如同鱼的鳍一般。	Hard 30 31 鳍
正发呆时，陡听得‘当’的一声，又若金钟铜磬一般，倒吓得不住的展眼儿。	Hard 30 33 展眼儿
他们唱给天空听，天那么高，调子爱扯多高就扯多高，没人会笑他们扯不上去；他们唱给牛羊和花草听，牛羊爱听不听，只顾悠闲地吃草；他们唱给大地听，大地绵延数里，歌的尾音就可以爱拖多远就拖多远，没人会笑他们荒腔走板；何况人群又离得那样远，声音就爱唱多响就唱多响，没人会怪他们五音不全、叨扰四邻。	Hard 98 102 荒腔走板
那里的椴树高大而阴凉，	Hard 3 5 椴树
他的脸上呈现出悲剧，一张含蓄了许多愁苦和力量的脸；火一样蓬勃的头发，盖在他的头上，好像有生以来从未梳过；深邃的眼睛略带灰色，有一种凝重不可逼视的光；长而笨重的鼻子下一张紧闭的嘴，衬着略带方形的下颏，整个描绘出坚忍无比的生的意志。	Hard 96 98 下颏
再瞧瞧那江攒聚的怪石奇峰，峰峰都是瘦骨嶙峋的，却又那样玲珑剔透，千奇百怪，有的像大象在江边饮水，有的像天马腾空欲飞，随着你的想像，可以变幻成各种各样神奇的物件。	Complex 5 7 攒聚
为了改良花卉的颜色、香味、形状和保鲜期等多方面的性状，科学家们的思路是首先要了解这些性状的生理机制，进而找到并克隆出与之直接或间接相关的各种基因，深入研究这些基因后，再修饰并转入到需要改良品质的花卉中，从而定向创造出花卉新品种。	Hard 4 6 花卉
次日早起五更，在府里把担仗都摆在厅前，老都管和两个虞候又将一小担财帛，共十一担，拣了十一个壮健的厢禁军，都做脚夫打扮。	Hard 11 13 担仗
地下两溜十六张楠木交椅，又有一副对联，乃乌木联牌，镶着錾银的字迹，道是：	Hard 2 4 两溜
我们的文明中有许多不健康的因素，如果我们想在疾病蔓延起来以前根除它们，就必须毫不留情地揭露它们；如果我们希望我们的文明能为自己辩护，我们必须尽最大力量去净化它。	Complex 38 42 毫不留情
那人听了，连连点头，依依不舍地拜别说：“有机会，我自然要感恩图报。”	Complex 10 14 依依不舍
时至今日，“克隆”的含义已不仅仅是“无性繁殖”，凡来自一个祖先，经过无性繁殖出的一群个体，也叫“克隆”。	Complex 18 22 无性繁殖
在他那很发达的脑门上竖立着很短的头发，直挺挺的鼻子像是被人很突然地在那长满浓密胡子的嘴上一刀切断了。	Complex 19 22 直挺挺
在它最繁华的渔人码头旁，居然卧着上百头野生的大海狮，旁若无人地打斗、游戏、抢地盘，引来无数游人驻足观赏。	Complex 47 51 驻足观赏
表演的尾声，也是最高潮，在欢乐的音乐声中，象群翩翩起舞，观众都拥到了宽阔的场地上，人群和象群混杂在一起舞之蹈之，热烈的气氛感染了在场的每一个人。	Complex 9 11 高潮
梁思成第一个抓住铁索，两腿悬空的往刹尖攀援。	Complex 19 21 攀援
例如《诗经·鲁颂》的《駉》这一首诗里提到马的名称就有16种：“驈”(身子黑而胯下白的)，“皇”(黄白相间的)，“骊”(纯黑色的)，“黄”(黄而杂红的)，“骓”(青白杂的)，“駓”(黄白杂的)，“騂”(红黄色的)，“骐”(青黑成纹像棋道的)，“驒”(青黑色而有斑像鱼鳞的)，“骆”(白马黑鬃)，“駵”(红马黑鬃)，“雒”(黑马白鬃)，“駰”(灰色有杂毛的)，“騢”(红白杂毛的)，“驔”(小腿长白毛的)，“鱼”(两眼旁边毛色白的)。	Hard 97 98 騂
“男爵爱卿，”他厉声言道，“朕想卿也明白，‘陛下’这个称呼在全国范围内只属于孤家一人，再没有旁人称得起‘陛下’了！	Hard 3 5 爱卿
巴比伦人只知道灌溉，却不懂得排水清田，使美索不达米亚的地下水位不断上升，给这片沃土罩上了一层又厚又白的盐外壳，有的地方竟像镜子一般闪闪发光。	Complex 14 18 排水清田
每扯下一页，它新的一页————光亮而开阔的一天便笑嘻嘻地等着我去填满。	Complex 24 27 笑嘻嘻
我说：“我要嫁那个卖灶糖的老汉！”	Hard 10 12 灶糖
远远地望过去，收割过的田野变得很亮，没有叶的枝干，淋着雨的草垛，对着瓷色的天空，像一幅干净利落的木刻。	Complex 29 31 草垛
“到范墓去粜没有好处，”同伴间也提出了驳议。	Hard 5 6 粜
我要看那滚滚的波涛，我要听那鞺鞺鞳鞳的咆哮，我要漂流到那没有阴谋、没有污秽、没有自私自利的没有人的小岛上去呀！	Hard 14 18 鞺鞺鞳鞳
我回到堂前，看见中堂挂着的立轴──吴昌硕描的墨竹，似觉更有意味。	Hard 8 10 中堂
到城里当清洁工、建筑工，干最脏最累的活儿，使城市高楼林立、清洁整齐的农民，以及他们的饱经沧桑而仍然坚守土地的父母。	Complex 24 28 高楼林立
我家的厨师是一个足智多谋的人，除了调和鼎鼐之外还贯通不少的左道旁门，他因为厨房里的肉常常被猫拖拉到灶下，鱼常被猫叼着上了墙头，怀恨于心，于是殚智竭力，发明了一个简单而有效的捕猫方法。	Complex 24 26 贯通
他站在一边不走了，嘴里念念有词，不停地抱怨着他们所受的种种苦难——有的是真的，有的是他的幻觉。	Complex 11 15 念念有词
祖父一个下半天来，都弯着个腰在船上拉来拉去，歇歇时手也酸了，腰也酸了，照规矩，一到家里就会嗅到锅中所焖瓜菜的味道，且可看见翠翠安排晚饭在灯光下跑来跑去的影子。	Complex 45 46 嗅
当多数缺少天赋的人将自己的阅读能力很快就只用来读报上的新闻或商业版时，少数人仍然迷恋于字母和文字的特殊魅力（因为它们古时候都曾经是富有魔力的符箓和咒语）。	Hard 70 72 符箓
单瓣的花虽没有双瓣者的豪华，但它却更有一段妙幻的演艺，红玛瑙的花瓶儿由希腊式的安普刺变为中国式的金罍，殷、周时代古味盎然的一种青铜器。	Hard 48 50 金罍
正发呆时，陡听得‘当’的一声，又若金钟铜磬一般，倒吓得不住的展眼儿。	Complex 17 21 金钟铜磬
及至始皇，奋六世之余烈，振长策而御宇内，吞二周而亡诸侯，履至尊而制六合，执敲扑而鞭笞天下，威振四海。	Hard 40 42 鞭笞
至于苗、瑶族则尚青黑而爱彩色，也比较懂色彩，因此使用到衣裙上的挑花，多用青布作地，上加彩线或棕黄绿，即同属一地区挑花，艺术效果也显然不同。	Hard 7 8 尚
祥林嫂似很局促了，立刻敛了笑容，旋转眼光，自去看雪花。	Complex 16 18 旋转
这个机关的负责人帮助保尔住进了一所专科医院。	Hard 17 21 专科医院
他发现了黑洞的蒸发性，推论出黑洞的大爆炸……	Hard 7 10 蒸发性
儿子惊喜地望着鸽子，但语气中却充满了忧虑，仿佛突然走进一个新奇的世界，而这个世界会因为我的“强权”瞬息即逝，使他来不及领略其中的瑰丽。	Complex 49 53 瞬息即逝
掩映在绿树丛中的港督府于1885年建成，在以后的近一个半世纪中，包括彭定康在内的许多港督曾对其进行过大规模改建、扩建和装修。	Complex 0 2 掩映
晚饭摆出来了，四叔俨然的陪着。	Hard 9 11 俨然
当它们觉察到远方的食物时，于是，长长的队伍像触角一样伸出来，越过平地，翻过高墙，绕过巨石，去把食物搬回来。	Complex 3 5 觉察
当他往家里走去时，他这样想，没有充分证据断定是那年轻人偷窃了自己的钱包，自己以后要把钱包保护的更好就是了；他以十二分的善意去帮助陌生人并没有错，这样的事情过去倒是做的太少了，而且，应该有更多的人乐于以自己的行动——哪怕只是热情为人带路这样的小善，来点滴增加这社会的人际温暖与亲善……	Complex 27 29 偷窃
当时嘉定名“药斑布”，苏州名“浇花布”，《醉金》一书中则名“浆水缬”，生产实具全国性。	Hard 30 33 浆水缬
你只会感到更高邈、深远，并让凄冷的雨滴，去纯净你的灵魂，而且一定会遥望到一场秋雨后将出现的一个更净美、开阔的大地。	Hard 6 8 高邈
它生得跟旗鱼一样，不同的是它那巨大的两颚，游得快的时候两颚紧闭起来。	Complex 27 29 两颚
用最精细确定的形式来逗出不可名言、难于凑泊的境界，恰符合魏尔兰论诗的条件：	Hard 17 21 难于凑泊
试验方式是先用紫外线照射爪蟾卵细胞，破坏其中的核，然后依靠高超的外科手术从爪蟾蝌蚪的肠上皮细胞、肝细胞、肾细胞中取出核，并把这些细胞的核精确地放进已被紫外线破坏了细胞核的卵细胞内。	Complex 37 39 爪蟾
一直奔到大海，仍然毫无惧色，纷纷跳将下去，被汹涌澎湃的波涛吞没，直到全军覆没为止。	Complex 22 26 汹涌澎湃
说时迟，那时快，武松见大虫扑来，一闪，闪在大虫背后。	Hard 11 13 大虫
王子生日那天，成千上万的人聚集到王宫前面的广场。	Complex 7 11 成千上万
于是六国之士，有宁越、徐尚、苏秦、杜赫之属为之谋，齐明、周最、陈轸、召滑、楼缓、翟景、苏厉、乐毅之徒通其意，吴起、孙膑、带佗、倪良、王廖、田忌、廉颇、赵奢之伦制其兵。	Hard 31 33 陈轸
教授们宣布说，所有科学上的问题最后都被亚里士多德一劳永逸地解决了。	Complex 24 28 一劳永逸
老头子站起来，拾起篙，撑了一下。	Hard 9 10 篙
一片片低矮的破房子仿佛是一片片疥疮。	Hard 15 17 疥疮
顿时，一种不可名状的恐惧感紧紧地攫住了我。	Hard 16 17 攫
例如《诗经·鲁颂》的《駉》这一首诗里提到马的名称就有16种：“驈”(身子黑而胯下白的)，“皇”(黄白相间的)，“骊”(纯黑色的)，“黄”(黄而杂红的)，“骓”(青白杂的)，“駓”(黄白杂的)，“騂”(红黄色的)，“骐”(青黑成纹像棋道的)，“驒”(青黑色而有斑像鱼鳞的)，“骆”(白马黑鬃)，“駵”(红马黑鬃)，“雒”(黑马白鬃)，“駰”(灰色有杂毛的)，“騢”(红白杂毛的)，“驔”(小腿长白毛的)，“鱼”(两眼旁边毛色白的)。	Hard 56 57 骊
他居然把亚里土多德的神圣的卷帙从书架上搬走，而代之以绳索、锡块、杠杆，圆形的、多角形的、平面的这样那样滑稽的玩意儿。	Hard 13 15 卷帙
我想天下第一等苦人，便是厌恶自己本业的人，这件事分明不能不做，却满肚子里不愿意做。	Complex 7 9 苦人
茶水对这山旮旯的群众来说，确实新鲜。	Hard 4 7 山旮旯
假如弄明白的话，我一伸手就会把这个对蜣螂来说沉重无比的粪蛋轻松拿起来，放到它的家里。	Hard 18 20 蜣螂
围观的农民非常奇怪，一位老人拍拍沃特森的肩膀，说：“小伙子，你是在喊屋里的那个人吗？	Complex 0 2 围观
若兰从小酷爱读书，18岁以优异成绩考入湖南第三女子师范学院，不久就投身到革命斗争的洪流中去，成为能文能武、机智勇敢的女战士。	Complex 41 43 洪流
哈姆莱特先生，他对于您这一番描写，的确可以当之无愧；虽然我知道，要是把他的好处一件一件列举出来，不但我们的记忆将要因此而淆乱，交不出一篇正确的账目来，而且他这一艘满帆的快船，也决不是我们失舵之舟所能追及；可是，凭着真诚的赞美而言，我认为他是一个才德优异的人，他的高超的禀赋是那样稀有而罕见，说一句真心的话，除了在他的镜子里以外，再也找不到第二个跟他同样的人，纷纷追踪求迹之辈，不过是他的影子而已。	Complex 60 62 淆乱
他们便无法想象这是一幢怎样的房子。	Complex 9 11 一幢
酒保唱了喏，认得是鲁提辖，便道：“提辖官人，打多少酒？”	Hard 17 21 提辖官人
盛赞兵马俑的报道和文章不断出现在世界各大媒体上，秦始皇陵兵马俑在世界范围里掀起了“中国热”。	Complex 0 2 盛赞
邮车上还套着三匹马，响着铃铛，坐着醉醺醺的邮差。	Complex 17 20 醉醺醺
这样，钱老才又在科技委干了五年。	Hard 8 11 科技委
“别想啦，老家伙，”他又放开嗓子说。	Complex 14 16 嗓子
联邦主席、女士们、先生们：	Hard 0 2 联邦
如果我们每天都这样地问问自己，这样地激励和鞭策自己，我们就一定能在身体健康、学问进修、工作效能、道德品格各方面有长足的进步。	Complex 21 23 鞭策
小黄牛栽下了一棵小椿树，树叶在春风中欢快地抖动着。	Complex 9 11 椿树
斜刺里两只老鸟箭也似的飞来，接住了它，衔上巢去。	Complex 19 20 衔
极天云一线异色，须臾成五采。	Hard 0 3 极天云
草原上的花，即使把它们直接移植到天堂上去，也——毫无愧色。	Complex 24 28 毫无愧色
那七个人道：“客官请几个枣子了去。”	Complex 7 9 客官
您瞧上去像是一个很好的法官；您懂得法律，您讲的话也很有道理，不愧是法律界的中流砥柱，所以现在我就用法律的名义，请您立刻进行宣判，凭着我的灵魂起誓，谁也不能用他的口舌改变我的决心。	Complex 37 41 中流砥柱
一个冬天的夜里，她从歌剧院回来，冻得全身直打哆嗦，第二天不停地咳嗽，一个星期以后就害肺炎死了。	Complex 41 42 害
当她累了的时候，就把头缩在壳里打个盹儿。	Complex 15 19 打个盹儿
我不知道他们给了我多少日子;但是我的手确乎是渐渐空虚了。	Complex 24 26 空虚
我们听着小鸟的欢叫，闻着小草的芳香，感受着阳光的温暖，当然也带回了写日记的灵感。	Complex 37 39 灵感
燕雀、鸢和歌声婉转的鸫鸟,用清脆、纯净的声音唱着。	Hard 10 12 鸫鸟
“后之视今，亦犹今之视昔”，你们不久也要走这条路呢！	Hard 7 9 犹今
那时黄被暗杀在美国，我拜读他的《远生遗著》，觉得文笔和观力都是值得钦佩的，但微嫌浅露，缺少含蓄。	Complex 45 47 含蓄
崔杼不再说话,吩咐手下把他也杀了。	Complex 7 9 吩咐
再说进化论的创立者达尔文。	Complex 2 5 进化论
说完他搁下了电话。	Complex 3 4 搁
他呻吟，哀求一点施舍。	Complex 1 3 呻吟
只是它的联想的意义迷离不易捉摸，它可以联想到燃烧弹，鸦片烟榻，庙里焚香，“一川烟水”，“杨柳万条烟”，“烟光凝而暮山紫”，“蓝田日暖玉生烟”……	Hard 44 49 杨柳万条烟
有的还是花骨朵儿，看起来饱胀得马上要破裂似的。	Complex 12 14 饱胀
再进去，太和门和太和殿、中和殿、保和殿成为一组“前三殿”与乾清门和乾清宫、交泰殿、坤宁宫成为一组的“后三殿”的大同小异的重复，就更像乐曲中的主题和“变奏”；每一座的本身也是许多构件和构成部分（乐句、乐段）的重复；而东西两侧的廊、庑、楼、门，又是比较低微的，以重复为主但亦有相当变化的“伴奏”。	Hard 114 115 庑
可是，在自然看来，人类上下翻飞的这片巨大空间，不过是咫尺之间而已，就如同鲲鹏看待斥鴳一般，只是蓬蒿之间罢了。	Hard 40 42 斥鴳
藕荷色的小蝴蝶，背着圆壳的小蜗牛，嗡嗡的蜜蜂，甚至于水里每夜乱唱的青蛙，在花丛中闪烁的萤虫，都是极温柔，极其孩子气的。	Hard 0 3 藕荷色
现在,陕西省洋县已被列入自然保护区,成群的朱鹮正在那里快乐地生活着。	Hard 21 23 朱鹮
海伦·凯勒这种不屈不饶的奋斗精神，永远留在世人的心中。	Complex 7 11 不屈不饶
──如果美是专指“婆娑”或“横斜逸出”之类而言，那么白杨树算不得树中的好女子；但是它却是伟岸，正直，朴质，严肃，也不缺乏温和，更不用提它的坚强不屈与挺拔，它是树中的伟丈夫！	Hard 9 11 婆娑
“下雨了”，温柔的灰美人来了，她冰冰的纤手在屋顶拂弄着无数的黑键啊灰键，把晌午一下子奏成了黄昏。	Complex 37 39 晌午
他还规定高山族子弟读书可以免除徭役。	Hard 15 17 徭役
二是说明读书的方法，不要固执一点，咬文嚼字，而要前后贯通，了解大意。	Complex 17 21 咬文嚼字
那些戴旧毡帽的大清早摇船出来，到了埠头，气也不透一口，便来到柜台前面占卜他们的命运。	Hard 10 12 摇船
至如梁、柱、枋、標、门、窗、墙、瓦、植、阶、栏杆、隔扇、斗拱、正脊、垂脊、正吻、戗兽、正房、厢房、游廊、庭院、夹道等等。	Hard 34 36 垂脊
那涓涓的地面溪流，透过石灰岩层下渗，在岩层内侵蚀穿凿，辟出一串串大大小小、弯弯曲曲的洞穴，久而久之演化为地下河流。	Complex 14 16 层下
恰好吃了三碗酒，店家再也不来筛了。	Complex 14 15 筛
如果说“人”只是指特定的基因”组，或者指“生物学的人”，那么可以说“克隆人”与他们的父本或母本是完全相同的。	Complex 34 37 克隆人
每日山后牛棚，拉着满车的牛乳罐的那匹斑白大马，我每日喂它。	Complex 14 15 罐
火是一部无始无终，百读不厌的书，你哪回看到两个形状相同的火焰呢！	Complex 4 8 无始无终
宽容，是我们自己的一幅健康的心电图，是这个世界的一张美好的通行证！	Complex 29 32 通行证
那只雄吐绶鸡一生下来脚上就有距，因此他就以为自己是一个皇帝。	Hard 2 6 雄吐绶鸡
于是我重又产生了那种想法：说不定，爷爷的毡靴就是永远不会完结。	Hard 20 22 毡靴
它跑到池塘边问青蛙：“青蛙哥哥，怎样才能快乐呢？”	Complex 3 5 池塘
“人文”这个词起源很早，《周易・责卦・彖辞》说：“观乎天文，以察时变；观乎人文，以化成天下。”	Hard 19 21 彖辞
他选了一群特别圈定的随员棗其中包括已经去看过的那两位诚实的大臣。	Hard 12 13 棗
如果五个月后，我不用再变成地球人，那么身体机能退化就没什么大不了的。	Complex 23 25 退化
当我第一次学写“河”字的时候，我想到的是浉河。	Hard 20 22 浉河
它是一堵垂直的峭壁，壁面有许多凸出来的岩石、崩土和蓬乱的灌木。	Hard 22 24 崩土
谁也想不到，胡早秋话没说完，周久义却挣扎着爬起来，仰天长啸一声：“围堰乡的老少爷们，我周久义对不起你们呀！”	Complex 33 36 围堰乡
她没答理跑来讨好自己的叭儿狗，没去看心爱的小羊羔儿，不理睬调皮的小牛犊儿。	Hard 11 14 叭儿狗
而笼子里换上了一只小豹，即使感觉最迟钝的人看到在弃置了如此长时间的笼子里，这只凶猛的野兽不停地蹦来跳去，他也会感到赏心悦目，心旷神怡。	Complex 24 26 弃置
你们试看那些繁殖在南美各地自由自在地生活着的马匹吧：它们行走着，它们奔驰着，它们腾跃着，既不受拘束，又没有节制；它们因不受羁勒而感觉自豪，它们避免和人打照面；它们不屑于受人照顾，它们能够自己寻找适当的食料；它们在无垠的草原上自由地游荡、蹦跳，采食着四季皆春的气候不断提供的新鲜产品；它们既无一定的住所，除了晴明的天空外又别无任何庇荫，因此它们呼吸着清新的空气，这种空气，比我们压缩它们应占的空间而禁闭它们的那些圆顶宫殿里的空气，要纯洁得多，所以那些野马远比大多数家马来得强壮、轻捷和遒劲。	Hard 61 63 羁勒
它们在劳动中经常是披着鞍辔的；人家从来不解除它们的羁绊，纵然是在休息的时候；如果人家偶尔让它们在牧场上自由地行走，它们也总是带着奴役的标志，并且还时常带着劳动与痛苦所给予的残酷痕迹：嘴巴被衔铁勒得变了形，腹侧留下一道道的疮痍或被马刺刮出一条条的伤疤，蹄子也都被铁钉洞穿了。	Hard 11 13 鞍辔
活人的塑像和大理石的塑像有一点不同，刀法如果用得不对，可以万像同毁，刀法如果用得对，则一笔下去，万龙点睛。	Hard 29 33 万像同毁
我们聆听着訇然作响的瀑声，只觉得自己的胸臆在扩展，似张开的山谷，那瀑布便直跃而进，挟来大自然生生不息的活力，回荡着大自然纯正清脆的音响。	Hard 5 9 訇然作响
奔腾不息的长江，转瞬间变成了一条暴怒的巨龙，疯狂的撕咬着千里江堤。	Complex 25 27 撕咬
在这迟疑之中，双喜可又看出底细来了，便又大声的说道，“我写包票！	Hard 29 31 包票
自然，也可以扩大精神，增加智识的，但这些倒都不计及，一计及，便等于意在赢钱的博徒了，这在博徒之中，也算是下品。	Complex 13 15 智识
真的，灯笼的缘结得太多了，记忆的网里挤着的就都是。	Hard 6 7 缘
这地方的火烧云变化极多，一会儿红彤彤的，一会儿金灿灿的，一会儿半紫半黄，一会儿半灰半百合色。	Complex 15 18 红彤彤
只能请那些在黄卷青灯间搔首苦吟的人们不要写诗了，那模样本不属于诗人。	Complex 11 15 搔首苦吟
范围是早自经史，晚到小说，旁及佛典，凡古人用做比喻的话，少自片语，多至成篇，无不采择，真可谓洋洋大观。	Complex 38 42 无不采择
但是，无论怎样地暴露自己，因为它们的数量实在太多，而天敌的数量却总是有限的，要靠这种方法来减少数量收效甚微。	Complex 49 53 收效甚微
例如《诗经·鲁颂》的《駉》这一首诗里提到马的名称就有16种：“驈”(身子黑而胯下白的)，“皇”(黄白相间的)，“骊”(纯黑色的)，“黄”(黄而杂红的)，“骓”(青白杂的)，“駓”(黄白杂的)，“騂”(红黄色的)，“骐”(青黑成纹像棋道的)，“驒”(青黑色而有斑像鱼鳞的)，“骆”(白马黑鬃)，“駵”(红马黑鬃)，“雒”(黑马白鬃)，“駰”(灰色有杂毛的)，“騢”(红白杂毛的)，“驔”(小腿长白毛的)，“鱼”(两眼旁边毛色白的)。	Hard 121 122 驒
今诸君苟不于此时植其基，勤其学，则将来万一因生计所迫，出而仕事，但任讲席，则必贻误学生；置身政界，则必贻误国家。	Hard 51 53 贻误
他们带利斧和美制的十字镐来，带工作灯来，人造的强光把举镐挥斧的影子投射在路面上，在公寓二楼的窗帘上，跳跃奔腾如巨无霸。	Hard 55 58 巨无霸
我们浏览着各种各样的春联，就像是漫游在万紫千红的百花园中。	Complex 2 4 浏览
于是，她便机智地与逢蒙周旋。	Hard 9 11 逢蒙
走到三阳春的门口，便可以看见书店里仍像往日那样地挤满了顾客，我可以安心了。	Hard 3 5 阳春
另外还要个拦头工人，上滩下滩时看水认容口，出事前提醒舵手躲避石头，恶浪与洑流，出事后点篙子需要准确，稳重。	Hard 18 20 容口
可是每星期日，我们都要衣冠整齐地到海边栈桥上去散步。	Hard 19 21 栈桥
黄翅飞蝗泥蜂的幼虫赖以为生的猎物，尽管有时完全不能动弹，却不是真正的尸体。	Hard 2 6 飞蝗泥蜂
她急切地思索着，一遍遍问自己：我该怎么办？	Complex 4 6 思索
根据他的身体状况，医疗小组决定不让他下海了。	Complex 9 11 医疗
她经常接济生活贫苦的乡亲，乡亲们都非常喜欢她。	Complex 3 5 接济
据说这第三条苏州街是乾隆皇帝为了给七十岁的母亲祝寿修建的。	Complex 6 9 苏州街
小蜘蛛用闪闪发亮的丝将自己悬挂在空中，有时候它们远离原来的楽穴，到几公里之外搭建新家，有时候它们就直接在遇到的第一根树枝上安家。	Hard 29 31 楽穴
中国的丝绸、铁器以及灌溉技术、炼钢技术和四大发明开始陆续西传。	Complex 10 12 灌溉
再还有‘日落江湖白，潮来天地青’：这‘白’‘青’两个字也似无理。	Hard 4 9 日落江湖白
它静静地盘旋，长久浮在空中，它好像看到了什么，径直俯冲下来，但还未触及地面又迅疾飞起。	Complex 23 27 径直俯冲
李白时代的诗人，既挚恋着四川的风土文物，又向往着下江的开阔文明，长江于是就成了他们生命的便道，不必下太大的决心就解缆问桨。	Hard 56 60 解缆问桨
当你发现书中所说哪怕是有一点与实际不符时，你就要揪住不放，因为这就意味着你的认识有了提高，你已经发现了问题，而发现问题往往是分析问题、解决问题的第一步。	Complex 24 25 揪
我看她头上已硬挠挠的挽了髻，便大嫂长大嫂短的向她道歉，说刚才这个同志来，说话不好别见怪等等。	Hard 6 9 硬挠挠
你似乎深不见底，宽不可测，没有人见过你的全貌。	Complex 3 7 深不见底
作为最高的效果，它格外赏赐了只属于幸福的少数人的，极罕见的摄身光。	Hard 29 32 摄身光
屠格涅夫也常常带来一些外文书籍，并非常流利地翻译一些歌德和普希金的诗句。	Hard 26 28 歌德
据王粲的《英雄记钞》说，诸葛亮与徐庶、石广元、孟公威等人一道游学读书，三人务于精熟，而亮独观其大略。	Hard 1 3 王粲
江理以“从者七人，二僧与俱”，组成一支浩浩荡荡的登山队，“一仆前持斧斤，剪伐丛莽，一仆鸣金继之，二三人肩糗执剑戟以随。”	Hard 41 47 一仆鸣金继之
星系们会继续以恒常速度相互离开。	Hard 7 9 恒常
起先，帕霍姆走得不慌不忙。	Hard 3 6 帕霍姆
上午11点钟左右，全茶峒人就吃了午饭。	Hard 10 12 茶峒
合众国总统将在白宫亲自把那一克儒赠给你。	Hard 13 16 一克儒
要不然，则当佳节大典之际，他们拿不出东西来，只好磕头贺喜，讨一点残羹冷炙做奖赏。	Hard 32 36 残羹冷炙
因此，尽管我的观点与他们截然不同，我还是要毫无顾忌、毫无保留地讲出自己的观点，并且希望不要因此而被认为是对先生们的不敬。	Complex 26 30 毫无保留
就这样，我们总是为了寻开心，揪掉这些不引人注目的小花。	Complex 14 15 揪
他们威胁说，否则，他们就将给他一顿教训，叫他永不会忘记。	Complex 2 4 威胁
于是那可怜的聋子把充满责怪和无限悲哀的眼光望着她。	Complex 6 8 聋子
“很简单，”怀特森老师眼里闪过狡黠的光芒，解释道，“有关凯蒂旺普斯的一切都是我编造的，这种动物从来就没有过。	Hard 15 17 狡黠
如果我们把这种具象化的旅行，抽象化为人生的旅途，我们不分彼此，都是苦旅者。	Hard 33 36 苦旅者
“绿”字描绘出了江南春风的气韵，引出下句“明月何时照我还”。	Complex 13 15 气韵
麦隆内夫人似平比居里夫人还要羞怯，她以记者为业已有二十多年了，可是在这个心灵毫不设防的黑衣女士面前，竟问不出一句话来。	Complex 38 42 毫不设防
细娃们都像喝了碗凉水，心里格外舒畅，一齐喊叫道：“该背时！	Hard 26 28 背时
范进即将这银子交与浑家打开看，一封一封雪白的细丝锭子，即便包了两锭，叫胡屠户进来，递与他道："方才费老爹的心，拿了五千钱来。	Hard 9 11 浑家
他们指着，描述着一些美丽的花纹棗事实上它们并不存在。	Hard 13 16 花纹棗
在欧洲的苏格兰，由于烟囱中冒出的煤灰沾在了雪花上，竟然下过一场黑雪。	Complex 10 12 烟囱
现在，我们离地球4万光年，我们正处于密集的银河中心。	Complex 21 23 银河
